rebellion_NOUN	восстание_NOUN
evidence_NOUN	доказательство_NOUN
mission_NOUN	миссия_NOUN
athlete_NOUN	спортсмен_NOUN
nomination_NOUN	кандидатура_NOUN
catch_VERB	поймать_VERB
demand_NOUN	требование_NOUN
appropriate_ADJ	уместный_ADJ
pearl_NOUN	жемчуг_NOUN
input_NOUN	ввод_NOUN
court_NOUN	суд_NOUN
except_ADP	кроме_ADP
archife_NOUN	архив_NOUN
bachelor_NOUN	бакалавр_NOUN
ridge_NOUN	ридж_NOUN
hitler_NOUN	гитлер_NOUN
character_NOUN	персонаж_NOUN
sun_NOUN	суть_NOUN
current_ADJ	нынешний_ADJ
annual_ADJ	годовой_ADJ
orientation_NOUN	направленность_NOUN
sport_NOUN	спорт_NOUN
piano_NOUN	пианино_NOUN
mount_NOUN	гора_NOUN
sign_NOUN	признак_NOUN
johann_NOUN	иоганн_NOUN
four_NUM	четыре_NUM
twenty_NUM	двадцать_NUM
equipment_NOUN	аппаратура_NOUN
neither_CCONJ	ни_CCONJ
driver_NOUN	драйвер_NOUN
default_NOUN	умолчание_NOUN
run_NOUN	бежать_NOUN
graham_NOUN	грэм_NOUN
george_NOUN	джордж_NOUN
head_NOUN	головка_NOUN
businessman_NOUN	бизнесмен_NOUN
remove_VERB	удалить_VERB
vessel_NOUN	сосуд_NOUN
form_VERB	сформировать_VERB
chair_NOUN	стул_NOUN
twitter_NOUN	твиттер_NOUN
saint_NOUN	святой_NOUN
case_NOUN	кейс_NOUN
rapid_ADJ	быстрый_ADJ
compete_VERB	конкурировать_VERB
district_NOUN	округ_NOUN
art_NOUN	арт_NOUN
connection_NOUN	соединение_NOUN
office_NOUN	офис_NOUN
enter_NOUN	ввод_NOUN
conversation_NOUN	разговор_NOUN
cave_NOUN	пещера_NOUN
planet_NOUN	планета_NOUN
schedule_NOUN	график_NOUN
banking_NOUN	банковский_NOUN
open_VERB	открывать_VERB
responsibility_NOUN	ответственность_NOUN
bill_NOUN	билл_NOUN
consistent_ADJ	последовательный_ADJ
exactly_ADV	точно_ADV
head_VERB	возглавлять_VERB
fix_VERB	починять_VERB
resident_NOUN	житель_NOUN
power_NOUN	полномочие_NOUN
baby_NOUN	детка_NOUN
islamic_ADJ	исламская_ADJ
bishop_NOUN	бишоп_NOUN
adam_NOUN	адавать_NOUN
kent_NOUN	кент_NOUN
testament_NOUN	завет_NOUN
romantic_ADJ	романтический_ADJ
revise_VERB	пересматривать_VERB
potential_NOUN	потенциал_NOUN
frequently_ADV	часто_ADV
product_NOUN	товар_NOUN
product_NOUN	продукция_NOUN
tool_NOUN	сервис_NOUN
threaten_VERB	угрожать_VERB
fall_NOUN	падение_NOUN
eat_VERB	есть_VERB
liberation_NOUN	освобождение_NOUN
victorian_ADJ	викторианский_ADJ
table_NOUN	столик_NOUN
worst_ADJ	худший_ADJ
sunk_VERB	потопить_VERB
lithuania_NOUN	литво_NOUN
boundary_NOUN	граница_NOUN
edit_NOUN	правка_NOUN
fun_NOUN	кайф_NOUN
improvement_NOUN	улучшение_NOUN
brazilian_ADJ	бразильский_ADJ
rock_NOUN	рок_NOUN
charter_NOUN	устав_NOUN
commercial_ADJ	коммерческий_ADJ
lie_VERB	врать_VERB
cattle_NOUN	скот_NOUN
defensive_ADJ	оборонительный_ADJ
clarke_NOUN	кларк_NOUN
delete_VERB	исключать_VERB
obviously_ADV	очевидно_ADV
request_NOUN	просьба_NOUN
particularly_ADV	особенно_ADV
service_NOUN	обслуживание_NOUN
criminal_ADJ	уголовный_ADJ
thompson_NOUN	томпсон_NOUN
estate_NOUN	поместье_NOUN
grid_NOUN	сетка_NOUN
she_PRON	она_PRON
fan_NOUN	поклонник_NOUN
heading_NOUN	заголовок_NOUN
law_NOUN	закон_NOUN
man_NOUN	человек_NOUN
crew_NOUN	экипаж_NOUN
virgin_NOUN	дева_NOUN
jew_NOUN	еврей_NOUN
forest_NOUN	лес_NOUN
establishment_NOUN	учреждение_NOUN
study_VERB	учиться_VERB
learn_VERB	учиться_VERB
autumn_NOUN	осень_NOUN
number_VERB	пронумеровать_VERB
flow_NOUN	поток_NOUN
episode_NOUN	эпизод_NOUN
legacy_NOUN	наследие_NOUN
order_VERB	приказывать_VERB
event_NOUN	мероприятие_NOUN
wall_NOUN	уоллар_NOUN
closely_ADV	тесно_ADV
poetry_NOUN	поэзия_NOUN
wright_NOUN	райт_NOUN
shah_NOUN	шах_NOUN
ron_NOUN	рон_NOUN
ensemble_NOUN	ансамбль_NOUN
score_VERB	забивать_VERB
conduct_NOUN	поведение_NOUN
lack_NOUN	недостаток_NOUN
economy_NOUN	экономия_NOUN
discovery_NOUN	открытие_NOUN
fee_NOUN	плата_NOUN
severe_ADJ	серьезный_ADJ
kate_NOUN	кейть_NOUN
delete_VERB	удалено_VERB
army_NOUN	армия_NOUN
work_NOUN	труд_NOUN
trouble_NOUN	беда_NOUN
brief_ADJ	краткий_ADJ
horse_NOUN	лошадь_NOUN
seem_VERB	казаться_VERB
appointment_NOUN	назначение_NOUN
item_NOUN	товар_NOUN
jurisdiction_NOUN	компетенция_NOUN
wellington_NOUN	веллингтон_NOUN
parameter_NOUN	параметр_NOUN
painter_NOUN	художник_NOUN
although_SCONJ	хотя_SCONJ
festival_NOUN	фестиваль_NOUN
chose_VERB	выбирать_VERB
right_ADV	верно_ADV
small_ADJ	малый_ADJ
sun_NOUN	сунуть_NOUN
food_NOUN	питание_NOUN
bat_NOUN	бить_NOUN
situation_NOUN	положение_NOUN
simple_ADJ	простой_ADJ
power_NOUN	мощность_NOUN
spirit_NOUN	дух_NOUN
initial_ADJ	первоначальный_ADJ
yard_NOUN	ярд_NOUN
alice_NOUN	алиса_NOUN
smaller_ADJ	меньший_ADJ
refer_VERB	ссылаться_VERB
construction_NOUN	конструкция_NOUN
origin_NOUN	происхождение_NOUN
manager_NOUN	менеджер_NOUN
selection_NOUN	подбор_NOUN
thread_NOUN	нитка_NOUN
commerce_NOUN	коммерция_NOUN
liu_NOUN	лять_NOUN
actual_ADJ	фактический_ADJ
fresh_ADJ	свежий_ADJ
dangerous_ADJ	опасный_ADJ
original_ADJ	первоначальный_ADJ
mention_VERB	упоминать_VERB
victim_NOUN	пострадавший_NOUN
begun_VERB	начинать_VERB
public_ADJ	публичный_ADJ
architectural_ADJ	архитектурный_ADJ
repair_NOUN	ремонт_NOUN
peter_NOUN	питер_NOUN
portion_NOUN	порция_NOUN
beautiful_ADJ	красивый_ADJ
assault_NOUN	атака_NOUN
discussion_NOUN	дискуссия_NOUN
incorrect_ADJ	неверный_ADJ
administrator_NOUN	администратор_NOUN
and_CCONJ	и_CCONJ
period_NOUN	период_NOUN
submission_NOUN	представление_NOUN
asia_NOUN	азие_NOUN
belief_NOUN	вера_NOUN
plant_NOUN	завод_NOUN
award_VERB	присуждать_VERB
activity_NOUN	действие_NOUN
technique_NOUN	метод_NOUN
warn_VERB	предупреждать_VERB
message_NOUN	послание_NOUN
class_NOUN	класс_NOUN
suddenly_ADV	вдруг_ADV
home_ADV	домой_ADV
completion_NOUN	завершение_NOUN
forward_ADV	вперед_ADV
wing_NOUN	крыло_NOUN
killer_NOUN	киллер_NOUN
fill_VERB	заполнять_VERB
request_VERB	просить_VERB
school_NOUN	школа_NOUN
output_NOUN	вывод_NOUN
date_NOUN	дата_NOUN
daughter_NOUN	дочь_NOUN
william_NOUN	вильямс_NOUN
legislative_ADJ	законодательный_ADJ
african_ADJ	африканский_ADJ
party_NOUN	вечеринка_NOUN
foot_NOUN	нога_NOUN
split_VERB	сплить_VERB
opposition_NOUN	оппозиция_NOUN
lake_NOUN	озеро_NOUN
sun_NOUN	воскресенье_NOUN
creative_ADJ	творческий_ADJ
without_ADP	без_ADP
begin_VERB	начинать_VERB
application_NOUN	приложение_NOUN
kid_NOUN	ребенок_NOUN
letter_NOUN	буква_NOUN
board_NOUN	совет_NOUN
woods_NOUN	лес_NOUN
customer_NOUN	клиент_NOUN
nomination_NOUN	номинация_NOUN
further_ADV	далее_ADV
prevent_VERB	предотвращать_VERB
permission_NOUN	разрешение_NOUN
wait_VERB	ждать_VERB
leaf_NOUN	лист_NOUN
ward_NOUN	уорд_NOUN
friend_NOUN	друг_NOUN
doctor_NOUN	доктор_NOUN
lane_NOUN	лэйн_NOUN
artistic_ADJ	художественный_ADJ
use_VERB	использовать_VERB
apparently_ADV	очевидно_ADV
tropical_ADJ	тропический_ADJ
match_NOUN	совпадение_NOUN
tampa_NOUN	тампе_NOUN
reader_NOUN	читатель_NOUN
water_NOUN	вода_NOUN
difference_NOUN	разногласие_NOUN
win_VERB	побеждать_VERB
nashville_NOUN	нэшвилла_NOUN
monster_NOUN	чудовище_NOUN
force_NOUN	усилие_NOUN
reach_NOUN	охват_NOUN
croatia_NOUN	хорватия_NOUN
current_ADJ	текущий_ADJ
professor_NOUN	профессор_NOUN
management_NOUN	руководство_NOUN
drum_NOUN	бочка_NOUN
hotel_NOUN	отель_NOUN
squad_NOUN	команда_NOUN
philip_NOUN	филипп_NOUN
demographic_NOUN	население_NOUN
television_NOUN	телевидение_NOUN
extra_ADJ	дополнительный_ADJ
jane_NOUN	джейн_NOUN
cross_NOUN	кросс_NOUN
meter_NOUN	метр_NOUN
feeling_NOUN	чувство_NOUN
opportunity_NOUN	возможность_NOUN
duty_NOUN	долг_NOUN
request_VERB	запрашивать_VERB
after_ADP	после_ADP
golf_NOUN	гольф_NOUN
party_NOUN	сторона_NOUN
convention_NOUN	конвенция_NOUN
philip_NOUN	филип_NOUN
scientist_NOUN	ученый_NOUN
pierre_NOUN	пьер_NOUN
encyclopedic_ADJ	энциклопедический_ADJ
ignore_VERB	игнорироваться_VERB
easier_ADJ	легкий_ADJ
sign_VERB	подписывать_VERB
status_NOUN	статус_NOUN
vega_NOUN	вегас_NOUN
raid_NOUN	рейд_NOUN
image_NOUN	картинка_NOUN
natural_ADJ	натуральный_ADJ
table_NOUN	таблица_NOUN
arm_NOUN	рука_NOUN
similarly_ADV	аналогично_ADV
spam_NOUN	спам_NOUN
casualty_NOUN	пострадавший_NOUN
chamber_NOUN	палата_NOUN
diseasis_NOUN	болезнь_NOUN
resolve_VERB	решать_VERB
barcelona_NOUN	барселон_NOUN
thailand_NOUN	таиланда_NOUN
franklin_NOUN	франклин_NOUN
josé_NOUN	хосе_NOUN
tour_NOUN	гастроль_NOUN
lord_NOUN	лорд_NOUN
raymond_NOUN	рэймонд_NOUN
issue_NOUN	вопрос_NOUN
stanford_NOUN	стэнфорд_NOUN
connect_NOUN	соединение_NOUN
robert_NOUN	робер_NOUN
nature_NOUN	характер_NOUN
grande_NOUN	гранде_NOUN
specifically_ADV	конкретно_ADV
often_ADV	часто_ADV
understanding_NOUN	взаимопонимание_NOUN
capacity_NOUN	емкость_NOUN
progressive_ADJ	прогрессивный_ADJ
however_ADV	однако_ADV
abuse_NOUN	злоупотребление_NOUN
fan_NOUN	фать_NOUN
belt_NOUN	пояс_NOUN
residence_NOUN	резиденция_NOUN
manila_NOUN	маниль_NOUN
commune_NOUN	коммуна_NOUN
louis_NOUN	людовик_NOUN
minor_ADJ	незначительный_ADJ
cylinder_NOUN	цилиндр_NOUN
union_NOUN	профсоюз_NOUN
roughly_ADV	приблизительно_ADV
time_NOUN	тайм_NOUN
library_NOUN	библиотека_NOUN
village_NOUN	деревня_NOUN
quality_NOUN	качество_NOUN
predecessor_NOUN	предшественник_NOUN
forever_ADV	навеки_ADV
appearance_NOUN	появление_NOUN
soon_ADV	вскоре_ADV
architecture_NOUN	архитектура_NOUN
junction_NOUN	перекрестка_NOUN
individual_ADJ	отдельный_ADJ
primary_ADJ	начальный_ADJ
redirect_VERB	перенаправлять_VERB
course_NOUN	курс_NOUN
vote_NOUN	голосование_NOUN
style_NOUN	стайлз_NOUN
decline_NOUN	упадок_NOUN
essay_NOUN	эссе_NOUN
lay_VERB	закладывать_VERB
stuart_NOUN	стюарт_NOUN
artwork_NOUN	оформление_NOUN
noise_NOUN	шум_NOUN
musician_NOUN	музыкант_NOUN
reconstruction_NOUN	восстановление_NOUN
service_NOUN	служба_NOUN
pay_VERB	оплачивать_VERB
save_VERB	сохранить_VERB
lead_VERB	ведущий_VERB
jersey_NOUN	джерси_NOUN
golden_ADJ	золотой_ADJ
manager_NOUN	руководитель_NOUN
check_VERB	проверить_VERB
murphy_NOUN	мёрфь_NOUN
amazon_NOUN	амазонка_NOUN
commander_NOUN	командующий_NOUN
know_VERB	знать_VERB
flood_NOUN	потоп_NOUN
erect_VERB	возвести_VERB
visual_ADJ	визуальный_ADJ
spanish_ADJ	испанский_ADJ
grow_VERB	вырастать_VERB
province_NOUN	провинция_NOUN
lincoln_NOUN	линкольн_NOUN
assistance_NOUN	помощь_NOUN
boy_NOUN	парень_NOUN
rank_NOUN	ранг_NOUN
security_NOUN	безопасность_NOUN
vice_NOUN	порок_NOUN
hammer_NOUN	молоток_NOUN
phase_NOUN	фаза_NOUN
visit_NOUN	посещение_NOUN
organisation_NOUN	организация_NOUN
shipping_NOUN	доставка_NOUN
argue_VERB	спорить_VERB
perfect_ADJ	идеальный_ADJ
move_VERB	переносить_VERB
reject_VERB	отклонять_VERB
leed_NOUN	лидс_NOUN
female_NOUN	женщина_NOUN
class_NOUN	занятие_NOUN
actively_ADV	активно_ADV
conflict_NOUN	конфликт_NOUN
role_NOUN	роль_NOUN
separate_VERB	разделять_VERB
cabinet_NOUN	шкаф_NOUN
pronounce_VERB	произносить_VERB
channel_NOUN	канал_NOUN
capacity_NOUN	вместимость_NOUN
legacy_NOUN	наследство_NOUN
sock_NOUN	носок_NOUN
operator_NOUN	оператор_NOUN
lawrence_NOUN	лоренс_NOUN
daniel_NOUN	дэниел_NOUN
garden_NOUN	гарден_NOUN
ride_NOUN	поездка_NOUN
flash_NOUN	флэш_NOUN
graphic_NOUN	график_NOUN
add_VERB	добавлять_VERB
compare_VERB	сравнивать_VERB
electricity_NOUN	электроэнергия_NOUN
claude_NOUN	клод_NOUN
numerous_ADJ	многочисленный_ADJ
energy_NOUN	энергетик_NOUN
weak_ADJ	слабый_ADJ
michel_NOUN	мишель_NOUN
middle_ADJ	ближний_ADJ
politician_NOUN	политик_NOUN
female_NOUN	самка_NOUN
support_NOUN	поддержка_NOUN
nationality_NOUN	национальность_NOUN
portuguese_NOUN	португалие_NOUN
entrance_NOUN	вход_NOUN
station_NOUN	вокзал_NOUN
fruit_NOUN	плод_NOUN
miguel_NOUN	мигель_NOUN
landing_NOUN	посадка_NOUN
revolution_NOUN	революция_NOUN
property_NOUN	свойство_NOUN
roughly_ADV	примерно_ADV
budget_NOUN	бюджет_NOUN
profit_NOUN	прибыль_NOUN
partially_ADV	частично_ADV
always_ADV	всегда_ADV
merchant_NOUN	торговец_NOUN
slovenia_NOUN	словение_NOUN
design_NOUN	проектирование_NOUN
secretary_NOUN	секретарь_NOUN
subject_NOUN	предмет_NOUN
fun_NOUN	веселье_NOUN
strip_NOUN	полоса_NOUN
arc_NOUN	арк_NOUN
camera_NOUN	фотоаппарат_NOUN
develop_VERB	развивать_VERB
basis_NOUN	основа_NOUN
cable_ADJ	кабельный_ADJ
deputy_NOUN	заместитель_NOUN
nichola_NOUN	николай_NOUN
occupation_NOUN	профессия_NOUN
stop_NOUN	остановка_NOUN
title_NOUN	заголовок_NOUN
really_ADV	реально_ADV
mount_NOUN	маунт_NOUN
additional_ADJ	дополнительный_ADJ
meet_VERB	встречать_VERB
construct_VERB	строить_VERB
dam_NOUN	плотина_NOUN
space_NOUN	космос_NOUN
vienna_NOUN	вена_NOUN
town_NOUN	городок_NOUN
slightly_ADV	незначительно_ADV
gay_NOUN	гей_NOUN
character_NOUN	характер_NOUN
conservative_ADJ	консервативный_ADJ
element_NOUN	элемент_NOUN
shipping_NOUN	судоходство_NOUN
nba_NOUN	нб_NOUN
development_NOUN	событие_NOUN
rate_VERB	оценивать_VERB
monday_NOUN	понедельник_NOUN
constant_ADJ	постоянный_ADJ
issue_NOUN	проблема_NOUN
makeup_NOUN	макияж_NOUN
improve_VERB	улучшаться_VERB
lesser_ADJ	меньший_ADJ
picture_NOUN	рисунок_NOUN
officer_NOUN	офицер_NOUN
hit_VERB	хит_VERB
look_VERB	смотреться_VERB
biological_ADJ	биологический_ADJ
bond_NOUN	бонд_NOUN
electric_ADJ	электрический_ADJ
latin_ADJ	латинский_ADJ
union_NOUN	союз_NOUN
der_NOUN	деревня_NOUN
han_NOUN	ханс_NOUN
madison_NOUN	мэдисон_NOUN
continent_NOUN	континент_NOUN
creek_NOUN	ручей_NOUN
call_NOUN	звонок_NOUN
different_ADJ	разный_ADJ
neutral_ADJ	нейтральный_ADJ
woods_NOUN	вудс_NOUN
actress_NOUN	актриса_NOUN
georgia_NOUN	джорджие_NOUN
diseasis_NOUN	заболевание_NOUN
mitchell_NOUN	митчел_NOUN
helicopter_NOUN	вертолет_NOUN
china_NOUN	китай_NOUN
base_VERB	основывать_VERB
commanded_VERB	повелевать_VERB
adventure_NOUN	приключение_NOUN
trinity_NOUN	троица_NOUN
max_NOUN	макс_NOUN
lane_NOUN	переулок_NOUN
meat_NOUN	мясо_NOUN
robert_NOUN	роберт_NOUN
car_NOUN	автомобиль_NOUN
florida_NOUN	флориде_NOUN
block_VERB	заблокировать_VERB
date_NOUN	финик_NOUN
detective_NOUN	детектив_NOUN
loan_NOUN	кредит_NOUN
zero_NOUN	нуль_NOUN
manuel_NOUN	мануэль_NOUN
transport_NOUN	транспорт_NOUN
chemistry_NOUN	химия_NOUN
pearl_NOUN	жемчужина_NOUN
asset_NOUN	актив_NOUN
stake_NOUN	ставка_NOUN
producer_NOUN	продюсер_NOUN
fire_VERB	уволить_VERB
financial_ADJ	финансовый_ADJ
swiss_NOUN	швейцария_NOUN
technology_NOUN	техника_NOUN
storm_NOUN	гроза_NOUN
detailed_ADJ	подробный_ADJ
death_NOUN	умирать_NOUN
american_ADJ	американский_ADJ
show_NOUN	показ_NOUN
presentation_NOUN	представление_NOUN
start_NOUN	начало_NOUN
demand_NOUN	спрос_NOUN
search_VERB	искать_VERB
paragraph_NOUN	пункт_NOUN
manufacturing_NOUN	изготовление_NOUN
assault_NOUN	штурм_NOUN
gear_NOUN	снаряжение_NOUN
land_VERB	приземляться_VERB
get_VERB	быть_VERB
time_NOUN	таймс_NOUN
muslim_NOUN	мусульманин_NOUN
harm_NOUN	вред_NOUN
kid_NOUN	парень_NOUN
painting_NOUN	рисование_NOUN
treaty_NOUN	договор_NOUN
whole_ADJ	целый_ADJ
combination_NOUN	сочетание_NOUN
ferry_NOUN	пар_NOUN
two_NUM	двое_NUM
criticism_NOUN	критика_NOUN
attorney_NOUN	адвокат_NOUN
agree_VERB	согласовывать_VERB
virus_NOUN	вирус_NOUN
lab_NOUN	лаборатория_NOUN
tail_NOUN	хвост_NOUN
clearly_ADV	явно_ADV
own_ADJ	собственный_ADJ
cemetery_NOUN	кладбище_NOUN
dancer_NOUN	танцовщица_NOUN
link_VERB	связывать_VERB
judgment_NOUN	суждение_NOUN
fleet_NOUN	флот_NOUN
possible_ADJ	возможный_ADJ
produce_VERB	производить_VERB
approximately_ADV	приблизительно_ADV
horn_NOUN	гудок_NOUN
sir_NOUN	середина_NOUN
see_VERB	смотреть_VERB
francis_NOUN	френсис_NOUN
race_NOUN	раса_NOUN
calendar_NOUN	календарь_NOUN
egyptian_ADJ	египетский_ADJ
consensus_NOUN	консенсус_NOUN
dictionary_NOUN	словарь_NOUN
declaration_NOUN	декларация_NOUN
travel_NOUN	поездка_NOUN
come_VERB	предстоять_VERB
neck_NOUN	шея_NOUN
formally_ADV	формально_ADV
interest_NOUN	интерес_NOUN
maritime_ADJ	морской_ADJ
age_NOUN	век_NOUN
seriously_ADV	серьезно_ADV
greek_ADJ	греческий_ADJ
investigation_NOUN	следствие_NOUN
palm_NOUN	пал_NOUN
battalion_NOUN	батальон_NOUN
athletic_NOUN	атлетика_NOUN
copy_NOUN	копия_NOUN
pitch_NOUN	подача_NOUN
battle_NOUN	сражение_NOUN
material_NOUN	материал_NOUN
height_NOUN	высота_NOUN
dating_NOUN	свидание_NOUN
interaction_NOUN	взаимодействие_NOUN
mile_NOUN	миля_NOUN
hotel_NOUN	гостиница_NOUN
anderson_NOUN	андерсон_NOUN
cousin_NOUN	кузина_NOUN
view_NOUN	вид_NOUN
perry_NOUN	перри_NOUN
expedition_NOUN	экспедиция_NOUN
benjamin_NOUN	бенджамин_NOUN
foundation_NOUN	основание_NOUN
auto_NOUN	авто_NOUN
temporarily_ADV	временно_ADV
server_NOUN	сервер_NOUN
distinction_NOUN	различие_NOUN
stat_NOUN	стить_NOUN
apparent_ADJ	очевидный_ADJ
label_NOUN	метка_NOUN
format_NOUN	формат_NOUN
cut_VERB	снимать_VERB
bishop_NOUN	слон_NOUN
experience_NOUN	опыт_NOUN
position_NOUN	должность_NOUN
case_NOUN	дело_NOUN
then_ADV	затем_ADV
fund_NOUN	средство_NOUN
cork_NOUN	корк_NOUN
s_VERB	петь_VERB
bus_NOUN	автобус_NOUN
reach_VERB	достигать_VERB
present_VERB	представлять_VERB
plan_VERB	запланировать_VERB
bowling_NOUN	боулинг_NOUN
killing_NOUN	убийство_NOUN
run_VERB	побежать_VERB
chain_NOUN	цепь_NOUN
feel_VERB	чувствовать_VERB
vocal_ADJ	голосовой_ADJ
advantage_NOUN	преимущество_NOUN
bar_NOUN	бар_NOUN
spend_VERB	проводить_VERB
gift_NOUN	дар_NOUN
develop_VERB	развивать_VERB
jonathan_NOUN	джонатана_NOUN
update_VERB	обновить_VERB
capital_NOUN	столица_NOUN
approximately_ADV	примерно_ADV
volunteer_NOUN	доброволец_NOUN
tower_NOUN	тауэр_NOUN
intelligence_NOUN	интеллект_NOUN
again_ADV	вновь_ADV
wolf_NOUN	вольф_NOUN
average_ADJ	средний_ADJ
enjoy_VERB	наслаждаться_VERB
singapore_NOUN	сингапурй_NOUN
margaret_NOUN	маргарита_NOUN
submit_VERB	представить_VERB
western_ADJ	западный_ADJ
finish_VERB	закончить_VERB
canal_NOUN	канал_NOUN
transition_NOUN	переход_NOUN
tags_NOUN	метка_NOUN
rural_ADJ	сельский_ADJ
brown_ADJ	коричневый_ADJ
competitor_NOUN	конкурент_NOUN
depict_VERB	изображать_VERB
programming_NOUN	программирование_NOUN
episcopal_ADJ	епископальный_ADJ
exercise_NOUN	упражнение_NOUN
monastery_NOUN	монастырь_NOUN
accusation_NOUN	обвинение_NOUN
gas_NOUN	бензин_NOUN
territorial_ADJ	территориальный_ADJ
call_VERB	звонить_VERB
awareness_NOUN	осведомленнодать_NOUN
funny_ADJ	смешной_ADJ
traditionally_ADV	традиционно_ADV
base_NOUN	база_NOUN
scott_NOUN	скот_NOUN
travel_NOUN	путешествие_NOUN
piece_NOUN	кусок_NOUN
respond_VERB	отвечать_VERB
road_NOUN	дорога_NOUN
investment_NOUN	инвестиция_NOUN
independently_ADV	независимо_ADV
dave_NOUN	дейв_NOUN
employ_VERB	занимать_VERB
violin_NOUN	скрипка_NOUN
mansion_NOUN	особняк_NOUN
aircraft_NOUN	авиация_NOUN
international_ADJ	международный_ADJ
mail_NOUN	почта_NOUN
manufacturer_NOUN	изготовитель_NOUN
mosque_NOUN	мечеть_NOUN
bosnia_NOUN	босние_NOUN
warrior_NOUN	воин_NOUN
fall_NOUN	осень_NOUN
manga_NOUN	манг_NOUN
these_DET	этот_DET
question_NOUN	вопрос_NOUN
australia_NOUN	австралия_NOUN
secretary_NOUN	секретарша_NOUN
warn_VERB	предупредить_VERB
connect_VERB	связывать_VERB
kick_NOUN	удар_NOUN
executive_ADJ	исполнительный_ADJ
substantial_ADJ	значительный_ADJ
truly_ADV	действительно_ADV
drama_NOUN	драма_NOUN
interpretation_NOUN	интерпретация_NOUN
luca_NOUN	люк_NOUN
longer_ADV	долго_ADV
spain_NOUN	испание_NOUN
compose_VERB	состоять_VERB
rate_VERB	оценить_VERB
wallace_NOUN	уоллес_NOUN
conspiracy_NOUN	сговор_NOUN
myself_PRON	себя_PRON
toronto_NOUN	торонто_NOUN
for_ADP	за_ADP
strong_ADJ	сильный_ADJ
march_NOUN	марш_NOUN
charge_NOUN	заряд_NOUN
manufacturer_NOUN	производитель_NOUN
rebel_NOUN	повстанец_NOUN
equal_ADJ	равный_ADJ
link_NOUN	линкать_NOUN
blank_ADJ	пустой_ADJ
symbol_NOUN	символ_NOUN
greatest_ADJ	великий_ADJ
segment_NOUN	сегмент_NOUN
four_NUM	четверо_NUM
positive_ADJ	позитивный_ADJ
condition_NOUN	состояние_NOUN
oil_NOUN	масло_NOUN
catherine_NOUN	катерина_NOUN
page_NOUN	страница_NOUN
exclusive_ADJ	исключительная_ADJ
historian_NOUN	историк_NOUN
vessel_NOUN	суд_NOUN
bill_NOUN	купюра_NOUN
crime_NOUN	преступление_NOUN
property_NOUN	имущество_NOUN
voter_NOUN	избиратель_NOUN
urban_ADJ	городской_ADJ
control_VERB	управлять_VERB
funny_ADJ	забавный_ADJ
look_VERB	искать_VERB
sister_NOUN	сестра_NOUN
rain_NOUN	дождь_NOUN
fifa_NOUN	фифа_NOUN
study_VERB	изучать_VERB
status_NOUN	состояние_NOUN
majority_NOUN	большинство_NOUN
division_NOUN	дивизия_NOUN
good_NOUN	груз_NOUN
clearer_ADJ	ясный_ADJ
learn_VERB	научаться_VERB
cruz_NOUN	крус_NOUN
start_VERB	начинаться_VERB
lane_NOUN	лейн_NOUN
accident_NOUN	случайность_NOUN
unsuccessful_ADJ	неудачный_ADJ
government_NOUN	правительство_NOUN
session_NOUN	заседание_NOUN
justice_NOUN	правосудие_NOUN
base_NOUN	основание_NOUN
artillery_NOUN	артиллерийский_NOUN
cloud_NOUN	облако_NOUN
balance_NOUN	баланс_NOUN
hear_NOUN	слух_NOUN
earlier_ADV	ранее_ADV
photo_NOUN	фотография_NOUN
court_NOUN	корт_NOUN
influential_ADJ	влиятельный_ADJ
injury_NOUN	ранение_NOUN
barry_NOUN	барри_NOUN
scholar_NOUN	ученый_NOUN
agreement_NOUN	соглашение_NOUN
steel_NOUN	сталь_NOUN
usually_ADV	обычно_ADV
hole_NOUN	дыра_NOUN
report_NOUN	доклад_NOUN
heaven_NOUN	небо_NOUN
gods_NOUN	бог_NOUN
amateur_NOUN	любитель_NOUN
confidence_NOUN	уверенность_NOUN
serving_NOUN	служение_NOUN
science_NOUN	наука_NOUN
labour_NOUN	труд_NOUN
faculty_NOUN	факультет_NOUN
effort_NOUN	усилие_NOUN
you_PRON	вы_PRON
specific_ADJ	конкретный_ADJ
display_NOUN	отображение_NOUN
jamaican_NOUN	ямаек_NOUN
client_NOUN	клиент_NOUN
frederick_ADJ	фридрий_ADJ
february_NOUN	февраль_NOUN
dick_NOUN	член_NOUN
body_NOUN	тело_NOUN
reserfe_NOUN	резерв_NOUN
price_NOUN	прайс_NOUN
preparation_NOUN	приготовление_NOUN
express_VERB	выражать_VERB
good_NOUN	товар_NOUN
fifteen_NUM	пятнадцать_NUM
supply_VERB	ставить_VERB
cash_NOUN	кэш_NOUN
sam_NOUN	сэм_NOUN
now_ADV	теперь_ADV
cross_NOUN	крест_NOUN
factory_NOUN	фабрика_NOUN
glass_NOUN	стакан_NOUN
launch_NOUN	запуск_NOUN
connection_NOUN	подключение_NOUN
palestine_NOUN	палестина_NOUN
emphasis_NOUN	акцент_NOUN
black_ADJ	черный_ADJ
pen_NOUN	перо_NOUN
prince_NOUN	принс_NOUN
column_NOUN	столбец_NOUN
snow_NOUN	сноу_NOUN
journey_NOUN	путешествие_NOUN
assume_VERB	предполагать_VERB
from_ADP	из_ADP
briefly_ADV	вкратце_ADV
execution_NOUN	казнь_NOUN
open_VERB	открываться_VERB
presidential_ADJ	президентский_ADJ
agree_VERB	согласовать_VERB
go_VERB	уходить_VERB
twin_NOUN	близнец_NOUN
release_VERB	выпускать_VERB
take_VERB	брать_VERB
magic_NOUN	магия_NOUN
october_NOUN	октябрь_NOUN
visit_NOUN	поездка_NOUN
influence_VERB	влиять_VERB
difference_NOUN	расхождение_NOUN
secondary_ADJ	средний_ADJ
guitarist_NOUN	гитарист_NOUN
fantasy_NOUN	фантазия_NOUN
selection_NOUN	отбор_NOUN
globe_NOUN	глобус_NOUN
invent_VERB	изобрести_VERB
journalism_NOUN	журналистика_NOUN
stand_VERB	стоять_VERB
year_NOUN	год_NOUN
powerful_ADJ	мощный_ADJ
plane_NOUN	самолет_NOUN
fee_NOUN	гонорар_NOUN
reception_NOUN	прием_NOUN
ball_NOUN	бал_NOUN
grand_NOUN	гранд_NOUN
sit_VERB	сидеть_VERB
queen_NOUN	царица_NOUN
bridge_NOUN	мост_NOUN
thanks_NOUN	спасибо_NOUN
fully_ADV	полностью_ADV
former_ADJ	бывший_ADJ
error_NOUN	ошибка_NOUN
guinea_NOUN	гвинея_NOUN
tape_NOUN	кассета_NOUN
shanghai_NOUN	шанхай_NOUN
declaration_NOUN	заявление_NOUN
associate_VERB	ассоциированный_VERB
sample_NOUN	выборка_NOUN
personally_ADV	лично_ADV
blake_NOUN	блэйк_NOUN
tale_NOUN	сказка_NOUN
host_NOUN	организатор_NOUN
engage_VERB	молвить_VERB
district_NOUN	район_NOUN
balance_NOUN	остаток_NOUN
idea_NOUN	идея_NOUN
fact_NOUN	факт_NOUN
tradition_NOUN	традиция_NOUN
energy_NOUN	энергия_NOUN
represent_VERB	представлять_VERB
mathematics_NOUN	математика_NOUN
unclear_ADJ	неясный_ADJ
burial_NOUN	похороны_NOUN
mental_ADJ	психический_ADJ
cost_NOUN	затрата_NOUN
cap_NOUN	кэп_NOUN
take_VERB	забрать_VERB
shooting_NOUN	съемка_NOUN
flee_VERB	бежать_VERB
racing_NOUN	скачка_NOUN
pianist_NOUN	пианист_NOUN
hook_NOUN	крюк_NOUN
georgia_NOUN	грузия_NOUN
combination_NOUN	комбинация_NOUN
experience_ADJ	опытный_ADJ
he_PRON	он_PRON
alternate_ADJ	альтернативный_ADJ
sight_NOUN	зрение_NOUN
remember_VERB	запоминать_VERB
matthew_NOUN	мэть_NOUN
specify_VERB	указать_VERB
interpretation_NOUN	толкование_NOUN
dick_NOUN	дикий_NOUN
duty_NOUN	обязанность_NOUN
combat_NOUN	бой_NOUN
prefer_VERB	предпочитать_VERB
grey_NOUN	серый_NOUN
nobel_NOUN	нобелевский_NOUN
militia_NOUN	ополченец_NOUN
commission_NOUN	комиссия_NOUN
drew_NOUN	др_NOUN
orlean_NOUN	орлеан_NOUN
certificate_NOUN	сертификат_NOUN
occasionally_ADV	изредка_ADV
promotional_ADJ	пропагандистский_ADJ
principle_NOUN	принцип_NOUN
division_NOUN	деление_NOUN
machine_NOUN	аппарат_NOUN
drop_VERB	уронить_VERB
jump_VERB	прыгнуть_VERB
improve_VERB	улучшать_VERB
incident_NOUN	происшествие_NOUN
infantry_NOUN	пехота_NOUN
stockholm_NOUN	стокгольмска_NOUN
banner_NOUN	знамя_NOUN
close_ADJ	закрытый_ADJ
subject_NOUN	субъект_NOUN
ice_NOUN	лед_NOUN
celebrate_VERB	праздновать_VERB
columbus_NOUN	колумб_NOUN
camp_NOUN	кэмп_NOUN
jew_NOUN	иудей_NOUN
dismiss_VERB	увольнять_VERB
architect_NOUN	архитектор_NOUN
ability_NOUN	способность_NOUN
monitor_NOUN	монитор_NOUN
mill_NOUN	милла_NOUN
wise_ADV	мудро_ADV
ref_NOUN	судья_NOUN
payment_NOUN	оплата_NOUN
luis_NOUN	луис_NOUN
policy_NOUN	политика_NOUN
nonsense_NOUN	вздор_NOUN
math_NOUN	математика_NOUN
leave_VERB	оставлять_VERB
believe_VERB	поверить_VERB
marriage_NOUN	брак_NOUN
external_ADJ	внешний_ADJ
miss_NOUN	мисс_NOUN
september_NOUN	сентябрь_NOUN
content_NOUN	материал_NOUN
drive_VERB	водить_VERB
interior_ADJ	внутренний_ADJ
carlo_NOUN	карластать_NOUN
wear_VERB	надевать_VERB
park_NOUN	парк_NOUN
food_NOUN	пища_NOUN
leadership_NOUN	руководство_NOUN
propose_VERB	предлагать_VERB
matrix_NOUN	матрица_NOUN
apply_VERB	применять_VERB
cape_NOUN	плащ_NOUN
information_NOUN	информация_NOUN
image_NOUN	образ_NOUN
iraq_NOUN	ирак_NOUN
satellite_NOUN	спутник_NOUN
model_NOUN	образец_NOUN
mark_NOUN	маркс_NOUN
boy_NOUN	мальчик_NOUN
limit_NOUN	лимит_NOUN
summit_NOUN	саммит_NOUN
sheet_NOUN	лист_NOUN
staff_NOUN	сотрудник_NOUN
syria_NOUN	сирия_NOUN
speech_NOUN	речь_NOUN
row_NOUN	строка_NOUN
lie_VERB	лгать_VERB
previously_ADV	ранее_ADV
manufacture_VERB	изготовлять_VERB
makeup_NOUN	грим_NOUN
division_NOUN	отдел_NOUN
francis_NOUN	фрэнсис_NOUN
korea_NOUN	корей_NOUN
maine_NOUN	мэн_NOUN
awareness_NOUN	осведомленности_NOUN
arc_NOUN	дуга_NOUN
slave_NOUN	раб_NOUN
herzegovina_NOUN	герцеговина_NOUN
beijing_NOUN	пекин_NOUN
help_NOUN	помощь_NOUN
colonel_NOUN	полковник_NOUN
allow_VERB	позволять_VERB
casualty_NOUN	жертва_NOUN
measure_NOUN	мера_NOUN
winner_NOUN	победитель_NOUN
summer_NOUN	лето_NOUN
anime_NOUN	аним_NOUN
reconstruction_NOUN	реконструкция_NOUN
armenia_NOUN	армение_NOUN
necessary_ADJ	необходимый_ADJ
cut_VERB	вырезать_VERB
shown_VERB	показывать_VERB
michael_NOUN	михаэль_NOUN
normal_ADJ	нормальный_ADJ
change_NOUN	перемена_NOUN
explain_VERB	объяснить_VERB
holiday_NOUN	отдых_NOUN
singapore_NOUN	сингапур_NOUN
line_NOUN	линия_NOUN
races_NOUN	гонка_NOUN
reservoir_NOUN	водохранилище_NOUN
widely_ADV	широко_ADV
beta_NOUN	бета_NOUN
probably_ADV	возможный_ADV
design_VERB	предназначать_VERB
daniel_NOUN	даниель_NOUN
corps_NOUN	корпус_NOUN
directly_ADV	напрямую_ADV
reliable_ADJ	надежный_ADJ
addition_NOUN	добавление_NOUN
address_NOUN	адрес_NOUN
website_NOUN	вебсайть_NOUN
land_NOUN	земля_NOUN
da_NOUN	дас_NOUN
moment_NOUN	минута_NOUN
triple_NOUN	тройной_NOUN
cyprus_NOUN	кипр._NOUN
reference_NOUN	ссылка_NOUN
show_NOUN	шоу_NOUN
proposal_NOUN	предложение_NOUN
presumably_ADV	предположительно_ADV
legion_NOUN	легион_NOUN
solid_ADJ	твердый_ADJ
nickname_NOUN	кличка_NOUN
spin_NOUN	вращение_NOUN
change_VERB	изменяться_VERB
short_ADJ	короткий_ADJ
oak_NOUN	дуб_NOUN
desire_NOUN	желание_NOUN
include_VERB	включить_VERB
escape_VERB	сбегать_VERB
quickly_ADV	быстро_ADV
category_NOUN	категория_NOUN
low_ADJ	низкий_ADJ
intersection_NOUN	пересечение_NOUN
convince_ADJ	убежденный_ADJ
testing_NOUN	испытание_NOUN
intend_VERB	предназначать_VERB
bass_NOUN	басса_NOUN
psychology_NOUN	психология_NOUN
declare_VERB	объявлять_VERB
rebellion_NOUN	бунт_NOUN
sentence_VERB	приговорить_VERB
awareness_NOUN	осознание_NOUN
pass_VERB	проходить_VERB
contribute_VERB	способствовать_VERB
world_NOUN	мир_NOUN
meeting_NOUN	совещание_NOUN
interview_NOUN	интервью_NOUN
index_NOUN	указатель_NOUN
weapon_NOUN	оружие_NOUN
charlotte_NOUN	шарлотта_NOUN
sur_NOUN	сюр_NOUN
implementation_NOUN	осуществление_NOUN
mercury_NOUN	меркурий_NOUN
develop_VERB	разрабатывать_VERB
logic_NOUN	логика_NOUN
communication_NOUN	сообщение_NOUN
herald_NOUN	геральд_NOUN
brunswick_NOUN	брансуик_NOUN
deploy_VERB	развернуть_VERB
sure_ADJ	уверенный_ADJ
impact_NOUN	эффект_NOUN
coalition_NOUN	коалиция_NOUN
parliamentary_NOUN	парламентский_NOUN
trust_VERB	доверять_VERB
concern_NOUN	забота_NOUN
mention_NOUN	упоминание_NOUN
autonomous_ADJ	самостоятельный_ADJ
scale_NOUN	шкала_NOUN
set_VERB	устанавливать_VERB
likely_ADV	вероятно_ADV
fifty_NUM	пятьдесят_NUM
fat_NOUN	жир_NOUN
collection_NOUN	сбор_NOUN
lewis_NOUN	льюис_NOUN
minority_NOUN	меньшинство_NOUN
aircraft_NOUN	самолет_NOUN
equipment_NOUN	оборудование_NOUN
tomb_NOUN	гробница_NOUN
act_NOUN	акт_NOUN
strike_NOUN	забастовка_NOUN
recipient_NOUN	получатель_NOUN
airline_NOUN	авиакомпания_NOUN
protect_VERB	охранять_VERB
traditional_ADJ	традиционный_ADJ
silver_NOUN	сильвирать_NOUN
obvious_ADJ	очевидный_ADJ
college_NOUN	колледж_NOUN
jone_NOUN	джонс_NOUN
file_VERB	подавать_VERB
again_ADV	опять_ADV
destruction_NOUN	разрушение_NOUN
younger_ADJ	молодой_ADJ
admit_VERB	признавать_VERB
anglican_ADJ	англиканский_ADJ
press_NOUN	пресс_NOUN
salt_NOUN	соль_NOUN
mitchell_NOUN	митчелл_NOUN
era_NOUN	эпоха_NOUN
method_NOUN	способ_NOUN
now_ADV	сейчас_ADV
competition_NOUN	соревнование_NOUN
movie_NOUN	фильм_NOUN
vanity_NOUN	тщеславие_NOUN
drummer_NOUN	барабанщик_NOUN
orbit_NOUN	орбита_NOUN
old_ADJ	старый_ADJ
bank_NOUN	бэнкс_NOUN
join_VERB	вступить_VERB
file_NOUN	файл_NOUN
walk_VERB	ходить_VERB
see_VERB	видеть_VERB
gender_NOUN	пол_NOUN
why_ADV	почему_ADV
man_NOUN	мужик_NOUN
bear_VERB	рождаться_VERB
regular_ADJ	регулярный_ADJ
columbia_NOUN	колумбия_NOUN
resource_NOUN	ресурс_NOUN
notice_NOUN	извещение_NOUN
memory_NOUN	воспоминание_NOUN
arbitration_NOUN	арбитраж_NOUN
substantial_ADJ	существенный_ADJ
cause_VERB	вызывать_VERB
suddenly_ADV	неожиданно_ADV
article_NOUN	изделие_NOUN
little_ADJ	маленький_ADJ
operation_NOUN	операция_NOUN
quarter_NOUN	квартал_NOUN
partly_ADV	отчасти_ADV
traffic_NOUN	пробка_NOUN
reality_NOUN	реальность_NOUN
princeton_NOUN	принстон_NOUN
comedy_NOUN	комедия_NOUN
equip_VERB	оснащать_VERB
responsible_ADJ	ответственный_ADJ
cavalry_NOUN	кавалерия_NOUN
housing_NOUN	жилье_NOUN
newspaper_NOUN	газета_NOUN
shakespeare_NOUN	шекспир_NOUN
larger_ADJ	крупный_ADJ
directly_ADV	непосредственно_ADV
identify_VERB	выявить_VERB
link_NOUN	ссылка_NOUN
schedule_VERB	планировать_VERB
repeatedly_ADV	неоднократно_ADV
definition_NOUN	определение_NOUN
order_NOUN	порядок_NOUN
purple_ADJ	фиолетовый_ADJ
departure_NOUN	выезд_NOUN
netherland_NOUN	нидерланды_NOUN
bring_VERB	привозить_VERB
view_NOUN	просмотр_NOUN
tournament_NOUN	турнир_NOUN
circle_NOUN	круг_NOUN
step_NOUN	ступенька_NOUN
engineer_NOUN	инжиниринг_NOUN
give_VERB	дарить_VERB
special_ADJ	специальный_ADJ
dublin_NOUN	дублин_NOUN
chess_NOUN	шахматы_NOUN
detail_NOUN	подробность_NOUN
student_NOUN	ученик_NOUN
strongly_ADV	решительно_ADV
clinton_NOUN	клинтон_NOUN
feedback_NOUN	отзыв_NOUN
ban_NOUN	запрет_NOUN
board_NOUN	доска_NOUN
lawyer_NOUN	адвокат_NOUN
benefit_NOUN	польза_NOUN
unity_NOUN	единство_NOUN
media_NOUN	медиа_NOUN
score_NOUN	счет_NOUN
foot_NOUN	стопа_NOUN
film_VERB	снимать_VERB
individual_ADJ	индивидуальный_ADJ
danny_NOUN	дэннь_NOUN
diverse_ADJ	разнообразный_ADJ
politician_NOUN	политика_NOUN
select_VERB	выбрать_VERB
customer_NOUN	покупатель_NOUN
upcoming_ADJ	ближайший_ADJ
independent_ADJ	независимый_ADJ
package_NOUN	пакет_NOUN
jazz_NOUN	джаз_NOUN
nationality_NOUN	гражданство_NOUN
seal_NOUN	печать_NOUN
pair_NOUN	пара_NOUN
wafe_NOUN	волна_NOUN
notable_ADJ	заметный_ADJ
american_NOUN	америка_NOUN
modern_ADJ	современный_ADJ
personal_ADJ	личный_ADJ
create_VERB	создавать_VERB
dominate_VERB	доминировать_VERB
bobby_NOUN	бобби_NOUN
regiment_NOUN	полк_NOUN
churche_NOUN	церковь_NOUN
abandon_VERB	бросать_VERB
two_NUM	два_NUM
taylor_NOUN	тэйлор_NOUN
metric_ADJ	метрический_ADJ
mines_NOUN	шахта_NOUN
exchange_NOUN	обмен_NOUN
want_VERB	разыскиваться_VERB
symptom_NOUN	симптом_NOUN
lift_VERB	поднимать_VERB
manage_VERB	удаваться_VERB
hat_NOUN	шапка_NOUN
bath_NOUN	баня_NOUN
entire_ADJ	целый_ADJ
participation_NOUN	участие_NOUN
student_NOUN	студентка_NOUN
country_NOUN	страна_NOUN
truth_NOUN	правда_NOUN
sequence_NOUN	последовательность_NOUN
evil_NOUN	злой_NOUN
chief_NOUN	вождь_NOUN
louis_NOUN	луис_NOUN
editorial_ADJ	редакционный_ADJ
population_NOUN	популяция_NOUN
tags_NOUN	тег_NOUN
down_ADV	вниз_ADV
dynamic_ADJ	динамический_ADJ
point_VERB	указывать_VERB
code_NOUN	кодекс_NOUN
form_NOUN	бланк_NOUN
heritage_NOUN	наследие_NOUN
decide_VERB	решить_VERB
length_NOUN	продолжительность_NOUN
cool_ADJ	крутой_ADJ
building_NOUN	строительство_NOUN
there_ADV	там_ADV
system_NOUN	система_NOUN
elect_VERB	избирать_VERB
private_ADJ	частный_ADJ
lead_VERB	вести_VERB
column_NOUN	колонна_NOUN
writer_NOUN	писатель_NOUN
trophy_NOUN	трофей_NOUN
law_NOUN	право_NOUN
room_NOUN	номер_NOUN
choice_NOUN	выбор_NOUN
locomotive_NOUN	локомотив_NOUN
picture_NOUN	фотография_NOUN
evening_NOUN	вечер_NOUN
road_NOUN	роуд_NOUN
attach_VERB	прилагать_VERB
patient_NOUN	пациентка_NOUN
attempt_NOUN	попытка_NOUN
unusual_ADJ	необычный_ADJ
moral_ADJ	моральный_ADJ
writings_NOUN	труд_NOUN
faculty_NOUN	преподаватель_NOUN
gallery_NOUN	галерея_NOUN
issue_NOUN	выпуск_NOUN
compilation_NOUN	подборка_NOUN
roger_NOUN	роджер_NOUN
prize_NOUN	премия_NOUN
commissioner_NOUN	комиссар_NOUN
editing_NOUN	редактирование_NOUN
cultural_ADJ	культурный_ADJ
sydney_NOUN	сидней_NOUN
correct_ADJ	правильный_ADJ
wood_NOUN	дерево_NOUN
development_NOUN	разработка_NOUN
summary_NOUN	резюме_NOUN
conference_NOUN	конференция_NOUN
piece_NOUN	кусочек_NOUN
indian_ADJ	индийский_ADJ
zero_NOUN	зеро_NOUN
source_NOUN	источник_NOUN
sweet_ADJ	сладкий_ADJ
workshop_NOUN	практикум_NOUN
pack_NOUN	стая_NOUN
serial_ADJ	серийный_ADJ
kill_VERB	убивать_VERB
bachelor_NOUN	холостяк_NOUN
moth_NOUN	моль_NOUN
operational_ADJ	оперативный_ADJ
chamber_NOUN	камера_NOUN
constitutional_ADJ	конституционный_ADJ
extension_NOUN	расширение_NOUN
composition_NOUN	состав_NOUN
paper_NOUN	бумага_NOUN
fishing_NOUN	рыболовство_NOUN
bruce_NOUN	брюс_NOUN
shot_NOUN	выстрел_NOUN
social_ADJ	социальный_ADJ
vancouver_NOUN	ванкувера_NOUN
white_ADJ	белый_ADJ
volleyball_NOUN	волейбол_NOUN
improvement_NOUN	совершенствование_NOUN
feat_NOUN	подвиг_NOUN
drink_NOUN	напиток_NOUN
surprise_NOUN	удивление_NOUN
german_NOUN	немец_NOUN
tall_ADJ	высокий_ADJ
effective_ADJ	эффективный_ADJ
grand_NOUN	грывать_NOUN
concern_NOUN	озабоченность_NOUN
comment_NOUN	замечание_NOUN
experiment_NOUN	эксперимент_NOUN
recently_ADV	недавно_ADV
pirate_NOUN	пират_NOUN
three_NUM	три_NUM
never_ADV	никогда_ADV
manchester_NOUN	манчестер_NOUN
ocean_NOUN	океан_NOUN
player_NOUN	игрок_NOUN
kingdom_NOUN	царство_NOUN
share_VERB	разделять_VERB
brigade_NOUN	бригада_NOUN
decision_NOUN	решение_NOUN
link_NOUN	связь_NOUN
blog_NOUN	блог_NOUN
side_NOUN	сторона_NOUN
poetry_NOUN	стих_NOUN
punishment_NOUN	наказание_NOUN
significant_ADJ	значительный_ADJ
especially_ADV	особенно_ADV
influence_NOUN	влияние_NOUN
possibly_ADV	возможный_ADV
peninsula_NOUN	полуостров_NOUN
diesel_NOUN	дизель_NOUN
promotion_NOUN	повышение_NOUN
cruz_NOUN	круз_NOUN
neighborhood_NOUN	окрестность_NOUN
suicide_NOUN	самоубийство_NOUN
dawn_NOUN	дон_NOUN
version_NOUN	версия_NOUN
house_NOUN	хауз_NOUN
roll_NOUN	роллар_NOUN
maurice_NOUN	мориса_NOUN
joseph_NOUN	иосиф_NOUN
free_ADJ	бесплатный_ADJ
college_NOUN	коллегия_NOUN
phenomenon_NOUN	явление_NOUN
nickname_NOUN	прозвище_NOUN
second_NOUN	секунда_NOUN
customer_NOUN	заказчик_NOUN
assistant_NOUN	ассистент_NOUN
draft_NOUN	драфт_NOUN
wildlife_NOUN	дикий_NOUN
fall_VERB	пасть_VERB
reflect_VERB	отражать_VERB
business_NOUN	бизнес_NOUN
sexual_ADJ	сексуальный_ADJ
run_VERB	бегать_VERB
hunter_NOUN	охотник_NOUN
colonial_ADJ	колониальный_ADJ
uniform_NOUN	униформа_NOUN
consideration_NOUN	рассмотрение_NOUN
note_NOUN	записка_NOUN
race_NOUN	гонка_NOUN
kong_NOUN	конг_NOUN
sabha_NOUN	сабх_NOUN
sometimes_ADV	пора_ADV
camp_NOUN	лагерь_NOUN
leg_NOUN	нога_NOUN
designation_NOUN	назначение_NOUN
preparation_NOUN	подготовка_NOUN
organise_VERB	организовывать_VERB
dollar_NOUN	доллар_NOUN
berlin_NOUN	берлин_NOUN
nelson_NOUN	нельсон_NOUN
unclear_ADJ	непонятный_ADJ
state_NOUN	состояние_NOUN
warning_NOUN	предостережение_NOUN
civilian_ADJ	гражданский_ADJ
totally_ADV	совершенно_ADV
here_ADV	здесь_ADV
seed_VERB	семенной_VERB
criteria_NOUN	критерий_NOUN
arizona_NOUN	аризон_NOUN
writer_NOUN	сценарист_NOUN
reputation_NOUN	репутация_NOUN
cross_VERB	пересечь_VERB
access_NOUN	доступ_NOUN
cause_NOUN	причина_NOUN
register_VERB	зарегистрировать_VERB
editing_NOUN	монтаж_NOUN
stick_NOUN	палка_NOUN
consider_VERB	учитывать_VERB
flora_NOUN	флора_NOUN
option_NOUN	вариант_NOUN
quartet_NOUN	четверка_NOUN
partly_ADV	частично_ADV
call_VERB	называться_VERB
front_NOUN	передний_NOUN
finish_VERB	заканчивать_VERB
ray_NOUN	рь_NOUN
photo_NOUN	фото_NOUN
wall_NOUN	стенка_NOUN
palmer_NOUN	палмирать_NOUN
first_ADV	сначала_ADV
virtually_ADV	практически_ADV
blind_ADJ	слепой_ADJ
child_NOUN	дитя_NOUN
settler_NOUN	поселенец_NOUN
publish_VERB	опубликовывать_VERB
inspiration_NOUN	вдохновение_NOUN
injury_NOUN	травма_NOUN
package_NOUN	упаковка_NOUN
employment_NOUN	трудоустройство_NOUN
board_NOUN	правление_NOUN
soft_ADJ	нежный_ADJ
absence_NOUN	отсутствие_NOUN
that_PRON	это_PRON
formula_NOUN	формула_NOUN
wale_NOUN	уэльс_NOUN
direct_ADJ	прямой_ADJ
measure_VERB	измерить_VERB
museum_NOUN	музей_NOUN
long_ADJ	длинный_ADJ
improve_VERB	улучшиться_VERB
commonwealth_NOUN	содружество_NOUN
genera_NOUN	род_NOUN
camera_NOUN	камера_NOUN
color_NOUN	цвет_NOUN
collin_NOUN	коллинз_NOUN
cool_ADJ	классный_ADJ
pat_NOUN	пэть_NOUN
heaven_NOUN	рай_NOUN
aspect_NOUN	аспект_NOUN
grace_VERB	благодать_VERB
border_NOUN	граница_NOUN
job_NOUN	вакансия_NOUN
download_NOUN	загрузка_NOUN
certificate_NOUN	свидетельство_NOUN
political_ADJ	политический_ADJ
finally_ADV	наконец_ADV
anthony_NOUN	энтоня_NOUN
mean_VERB	означать_VERB
davis_NOUN	дэвис_NOUN
roger_NOUN	роджерс_NOUN
memory_NOUN	память_NOUN
mad_ADJ	безумный_ADJ
discussion_NOUN	обсуждение_NOUN
translate_VERB	переводить_VERB
dream_NOUN	мечта_NOUN
knight_NOUN	конь_NOUN
accident_NOUN	авария_NOUN
step_NOUN	этап_NOUN
tie_NOUN	галстук_NOUN
expand_VERB	развертывать_VERB
relatively_ADV	относительно_ADV
corporate_ADJ	корпоративный_ADJ
similar_ADJ	похожий_ADJ
shell_NOUN	оболочка_NOUN
atlanta_NOUN	атланть_NOUN
panel_NOUN	панель_NOUN
mathematical_ADJ	математический_ADJ
demonstrate_VERB	продемонстрировать_VERB
tube_NOUN	трубка_NOUN
person_NOUN	лицо_NOUN
post_NOUN	размещение_NOUN
confidence_NOUN	доверие_NOUN
crew_NOUN	команда_NOUN
culture_NOUN	культура_NOUN
practical_ADJ	практический_ADJ
constitution_NOUN	конституция_NOUN
enemy_NOUN	враг_NOUN
but_CCONJ	но_CCONJ
publisher_NOUN	издатель_NOUN
mark_VERB	отмечать_VERB
approve_VERB	одобрять_VERB
replacement_NOUN	замена_NOUN
purchase_VERB	приобретать_VERB
sergeant_NOUN	сержант_NOUN
option_NOUN	параметр_NOUN
rank_NOUN	ряд_NOUN
unit_NOUN	подразделение_NOUN
community_NOUN	община_NOUN
shock_NOUN	шок_NOUN
edit_NOUN	редактирование_NOUN
note_NOUN	заметка_NOUN
site_NOUN	сайт_NOUN
volume_NOUN	объем_NOUN
task_NOUN	задача_NOUN
extend_VERB	продлевать_VERB
temperature_NOUN	температура_NOUN
relief_NOUN	облегчение_NOUN
soap_NOUN	мыло_NOUN
distinction_NOUN	разграничение_NOUN
chart_NOUN	диаграмма_NOUN
again_ADV	снова_ADV
delivery_NOUN	поставка_NOUN
median_ADJ	средний_ADJ
tribute_NOUN	дань_NOUN
sussex_NOUN	сассекс_NOUN
identification_NOUN	идентификация_NOUN
moon_NOUN	луна_NOUN
require_VERB	требовать_VERB
profile_NOUN	профиль_NOUN
final_NOUN	финал_NOUN
apartment_NOUN	квартира_NOUN
clan_NOUN	клан_NOUN
challenge_NOUN	проблема_NOUN
le_NOUN	лес_NOUN
battle_NOUN	битва_NOUN
develop_VERB	развиваться_VERB
foot_NOUN	ступня_NOUN
path_NOUN	путь_NOUN
fox_NOUN	лис_NOUN
nothing_PRON	ничто_PRON
phrase_NOUN	фраза_NOUN
korean_ADJ	корейский_ADJ
patrol_NOUN	патрулирование_NOUN
manor_NOUN	поместье_NOUN
upload_VERB	загружать_VERB
notice_NOUN	уведомление_NOUN
location_NOUN	местонахождение_NOUN
cover_VERB	охватывать_VERB
australian_ADJ	австралийский_ADJ
studio_NOUN	студия_NOUN
county_NOUN	округ_NOUN
successful_ADJ	успешный_ADJ
pop_NOUN	поп-группа_NOUN
release_NOUN	освобождение_NOUN
senator_NOUN	сенатор_NOUN
bear_NOUN	медвежонок_NOUN
injure_VERB	потерпевший_VERB
website_NOUN	сайт_NOUN
priest_NOUN	священник_NOUN
cell_NOUN	клетка_NOUN
alabama_NOUN	алабама_NOUN
installation_NOUN	установка_NOUN
miss_VERB	пропускать_VERB
come_VERB	идти_VERB
mile_NOUN	миль_NOUN
screen_NOUN	экран_NOUN
rifle_NOUN	ружье_NOUN
thread_NOUN	нить_NOUN
stack_NOUN	стек_NOUN
suggest_VERB	предложить_VERB
launch_NOUN	пуск_NOUN
elementary_ADJ	начальный_ADJ
pattern_NOUN	схема_NOUN
illegal_ADJ	незаконный_ADJ
box_NOUN	шкатулка_NOUN
dismiss_VERB	отклонять_VERB
suggest_VERB	рекомендовать_VERB
picture_VERB	представлять_VERB
vocalist_NOUN	вокалист_NOUN
youth_NOUN	молодость_NOUN
jose_NOUN	хосе_NOUN
mention_VERB	упомянуть_VERB
fire_NOUN	пожар_NOUN
knight_NOUN	найть_NOUN
office_NOUN	кабинет_NOUN
characteristic_NOUN	характеристика_NOUN
possession_NOUN	владение_NOUN
why_ADV	зачем_ADV
mile_NOUN	майлс_NOUN
supreme_ADJ	верховный_ADJ
publication_NOUN	издание_NOUN
feel_VERB	почувствовать_VERB
ross_NOUN	росс_NOUN
shooting_NOUN	стрельба_NOUN
arabia_NOUN	аравия_NOUN
award_NOUN	награда_NOUN
collective_ADJ	коллективный_ADJ
release_VERB	освобождать_VERB
cape_NOUN	мыс_NOUN
gun_NOUN	ствол_NOUN
painting_NOUN	живопись_NOUN
ordinary_ADJ	обычный_ADJ
difficulty_NOUN	трудность_NOUN
morris_NOUN	морриса_NOUN
look_VERB	выглядеть_VERB
remove_VERB	удалено_VERB
blue_NOUN	блюз_NOUN
recreation_NOUN	отдых_NOUN
disruptive_ADJ	подрывной_ADJ
academic_ADJ	академический_ADJ
beer_NOUN	пиво_NOUN
break_NOUN	перерыв_NOUN
doctor_NOUN	врач_NOUN
singer_NOUN	певица_NOUN
interview_NOUN	собеседование_NOUN
teacher_NOUN	учительница_NOUN
mostly_ADV	преимущественно_ADV
companion_NOUN	товарищ_NOUN
ensure_VERB	обеспечивать_VERB
engine_NOUN	двигатель_NOUN
pick_VERB	выбрать_VERB
lisa_NOUN	лиса_NOUN
crossing_NOUN	пересечение_NOUN
luke_NOUN	люк_NOUN
representation_NOUN	представительство_NOUN
fruit_NOUN	фрукт_NOUN
justice_NOUN	справедливость_NOUN
fisher_NOUN	фишер_NOUN
foot_NOUN	фут_NOUN
poster_NOUN	плакать_NOUN
tran_NOUN	транс_NOUN
april_NOUN	апрель_NOUN
industrial_ADJ	промышленный_ADJ
info_NOUN	информация_NOUN
inclusion_NOUN	включение_NOUN
burn_NOUN	бёрнс_NOUN
attack_NOUN	нападение_NOUN
drug_NOUN	наркотик_NOUN
hamilton_NOUN	гамильтон_NOUN
theology_NOUN	теология_NOUN
attendance_NOUN	посещаемость_NOUN
yourself_PRON	себя_PRON
greg_NOUN	грег_NOUN
enjoy_VERB	пользоваться_VERB
escape_VERB	сбежать_VERB
legal_ADJ	юридический_ADJ
dakota_NOUN	дакот_NOUN
identity_NOUN	личность_NOUN
cat_NOUN	кэть_NOUN
nominate_VERB	назначать_VERB
episode_NOUN	серия_NOUN
galaxy_NOUN	гэлакси_NOUN
british_ADJ	британский_ADJ
food_NOUN	еда_NOUN
diverse_ADJ	различный_ADJ
office_NOUN	канцелярия_NOUN
chinese_ADJ	китайский_ADJ
give_VERB	отдавать_VERB
sample_NOUN	образец_NOUN
soft_ADJ	мягкий_ADJ
child_NOUN	детский_NOUN
intervention_NOUN	вмешательство_NOUN
turner_NOUN	тёрнер_NOUN
missile_NOUN	ракета_NOUN
quartet_NOUN	квартет_NOUN
progress_NOUN	прогресс_NOUN
list_NOUN	перечень_NOUN
publish_VERB	опубликовать_VERB
score_VERB	набирать_VERB
boxing_NOUN	бокс_NOUN
ridge_NOUN	хребет_NOUN
chronicle_NOUN	хроника_NOUN
ancient_ADJ	древний_ADJ
weekend_NOUN	выходной_NOUN
earn_VERB	заслуживать_VERB
head_NOUN	орел_NOUN
extremely_ADV	крайне_ADV
degree_NOUN	степень_NOUN
monument_NOUN	памятник_NOUN
saturday_NOUN	суббота_NOUN
liberty_NOUN	свобода_NOUN
advocate_NOUN	адвокат_NOUN
grandfather_NOUN	дед_NOUN
democratic_ADJ	демократический_ADJ
job_NOUN	работа_NOUN
dragon_NOUN	дракон_NOUN
copper_NOUN	копейка_NOUN
network_NOUN	сеть_NOUN
industries_NOUN	отрасль_NOUN
among_ADP	среди_ADP
mp_NOUN	депутат_NOUN
compilation_NOUN	компиляция_NOUN
movement_NOUN	движение_NOUN
exhibition_NOUN	выставка_NOUN
navigation_NOUN	судоходство_NOUN
spend_VERB	тратить_VERB
fuel_NOUN	топливо_NOUN
shop_NOUN	магазин_NOUN
content_NOUN	контент_NOUN
number_NOUN	цифра_NOUN
surgery_NOUN	хирургия_NOUN
cook_VERB	приготовить_VERB
grove_VERB	гроуть_VERB
age_NOUN	возраст_NOUN
credit_NOUN	кредит_NOUN
block_NOUN	блокирование_NOUN
king_NOUN	король_NOUN
delete_NOUN	удаление_NOUN
balance_NOUN	равновесие_NOUN
identity_NOUN	идентичность_NOUN
stream_NOUN	поток_NOUN
compound_NOUN	соединение_NOUN
friend_NOUN	подруга_NOUN
floor_NOUN	пол_NOUN
districts_NOUN	округ_NOUN
abc_X	abс_X
revenue_NOUN	выручка_NOUN
birth_NOUN	рождение_NOUN
juan_NOUN	хуан_NOUN
art_NOUN	искусство_NOUN
strength_NOUN	сила_NOUN
pearl_NOUN	перл_NOUN
boat_NOUN	яхта_NOUN
everyone_PRON	все_PRON
nbc_X	nbс_X
activity_NOUN	активность_NOUN
former_ADJ	прежний_ADJ
global_ADJ	глобальный_ADJ
lady_NOUN	дама_NOUN
outer_ADJ	внешний_ADJ
caption_NOUN	подпись_NOUN
husband_NOUN	муж_NOUN
care_NOUN	уход_NOUN
neil_NOUN	нил_NOUN
lancashire_NOUN	ланкашира_NOUN
eagle_NOUN	игла_NOUN
week_NOUN	неделя_NOUN
wolf_NOUN	вульф_NOUN
brand_NOUN	бренд_NOUN
cat_NOUN	кппа_NOUN
freedom_NOUN	свобода_NOUN
suddenly_ADV	внезапно_ADV
light_NOUN	свет_NOUN
emergency_NOUN	чрезвычайный_NOUN
vision_NOUN	видение_NOUN
leg_NOUN	ножка_NOUN
burial_NOUN	захоронение_NOUN
palace_NOUN	дворец_NOUN
greece_NOUN	греция_NOUN
huge_ADJ	огромный_ADJ
distribute_VERB	распространенный_VERB
parker_NOUN	паркирать_NOUN
failure_NOUN	неудача_NOUN
paragraph_NOUN	абзац_NOUN
deny_VERB	отказывать_VERB
employee_NOUN	служащий_NOUN
beam_NOUN	пучок_NOUN
siege_NOUN	осада_NOUN
unnecessary_ADJ	лишний_ADJ
determine_VERB	определять_VERB
team_NOUN	команда_NOUN
registration_NOUN	регистрация_NOUN
human_ADJ	человеческий_ADJ
survive_VERB	выжить_VERB
relevant_ADJ	соответствующий_ADJ
gun_NOUN	пушка_NOUN
oil_NOUN	нефть_NOUN
vertical_ADJ	вертикальный_ADJ
positive_ADJ	положительный_ADJ
eye_NOUN	око_NOUN
implementation_NOUN	выполнение_NOUN
persian_ADJ	персидский_ADJ
bid_NOUN	ставка_NOUN
length_NOUN	протяженность_NOUN
post_VERB	опубликовывать_VERB
carbon_NOUN	углерод_NOUN
church_NOUN	церковь_NOUN
indigenous_ADJ	коренной_ADJ
where_ADV	где_ADV
reform_VERB	реформировать_VERB
dark_ADJ	темный_ADJ
train_NOUN	поезд_NOUN
attract_VERB	привлекать_VERB
interesting_ADJ	интересный_ADJ
competition_NOUN	конкурс_NOUN
bay_NOUN	бей_NOUN
separate_ADJ	отдельный_ADJ
gap_NOUN	разрыв_NOUN
control_NOUN	управление_NOUN
lack_NOUN	отсутствие_NOUN
guess_VERB	угадывать_VERB
slowly_ADV	потихоньку_ADV
transfer_NOUN	трансфер_NOUN
story_NOUN	рассказ_NOUN
command_NOUN	командование_NOUN
spectrum_NOUN	спектр_NOUN
live_VERB	жить_VERB
capture_VERB	поймать_VERB
eye_NOUN	глазок_NOUN
george_NOUN	георг_NOUN
institution_NOUN	учреждение_NOUN
respect_NOUN	респект_NOUN
elementary_ADJ	элементарный_ADJ
promote_VERB	продвигать_VERB
jon_NOUN	джон_NOUN
earth_NOUN	земля_NOUN
dynasty_NOUN	династия_NOUN
engine_NOUN	движок_NOUN
mistake_NOUN	ошибка_NOUN
protein_NOUN	белок_NOUN
initially_ADV	изначально_ADV
philosophy_NOUN	философия_NOUN
similar_ADJ	аналогичный_ADJ
battle_NOUN	бой_NOUN
parliament_NOUN	парламент_NOUN
fear_NOUN	страх_NOUN
settlement_NOUN	урегулирование_NOUN
participant_NOUN	участник_NOUN
recreation_NOUN	досуг_NOUN
leadership_NOUN	лидерство_NOUN
man_NOUN	мужчина_NOUN
three_NUM	трое_NUM
nick_NOUN	ник_NOUN
voice_NOUN	голос_NOUN
metal_NOUN	металл_NOUN
avoid_VERB	избегать_VERB
car_NOUN	машина_NOUN
squad_NOUN	взвод_NOUN
gun_NOUN	пистолет_NOUN
focus_NOUN	фокус_NOUN
traffic_NOUN	трафик_NOUN
truck_NOUN	грузовик_NOUN
effect_NOUN	эффект_NOUN
breaking_NOUN	взлом_NOUN
presentation_NOUN	презентация_NOUN
exposure_NOUN	воздействие_NOUN
perspective_NOUN	перспектива_NOUN
review_NOUN	обзор_NOUN
opponent_NOUN	оппонент_NOUN
leonard_NOUN	леонарды_NOUN
departure_NOUN	отъезд_NOUN
caption_NOUN	заголовок_NOUN
legitimate_ADJ	законный_ADJ
number_NOUN	номер_NOUN
riding_NOUN	езда_NOUN
employment_NOUN	занятость_NOUN
prince_NOUN	принц_NOUN
member_NOUN	член_NOUN
potentially_ADV	потенциально_ADV
teacher_NOUN	преподаватель_NOUN
japan_NOUN	японие_NOUN
ruler_NOUN	правитель_NOUN
stating_VERB	заявлять_VERB
mark_NOUN	метка_NOUN
signature_NOUN	подписание_NOUN
head_VERB	направлять_VERB
basis_NOUN	основание_NOUN
cuba_NOUN	куб_NOUN
square_NOUN	площадь_NOUN
set_VERB	сет_VERB
chicago_NOUN	чикаго_NOUN
promote_VERB	повышать_VERB
agent_NOUN	агент_NOUN
branch_NOUN	отделение_NOUN
spelling_NOUN	написание_NOUN
gang_NOUN	банда_NOUN
classical_ADJ	классический_ADJ
nancy_NOUN	нэнси_NOUN
family_NOUN	родные_NOUN
copy_NOUN	экземпляр_NOUN
resistance_NOUN	сопротивление_NOUN
topic_NOUN	тема_NOUN
prove_VERB	доказывать_VERB
damage_VERB	повреждать_VERB
pattern_NOUN	узор_NOUN
buy_VERB	покупать_VERB
protection_NOUN	охрана_NOUN
hong_NOUN	хон_NOUN
accurate_ADJ	точный_ADJ
lighting_NOUN	освещение_NOUN
territory_NOUN	территория_NOUN
selection_NOUN	выбор_NOUN
chuck_NOUN	чак_NOUN
grand_NOUN	штука_NOUN
plant_NOUN	растение_NOUN
burn_VERB	сжигать_VERB
faith_NOUN	вера_NOUN
glass_NOUN	бокал_NOUN
milwaukee_NOUN	милуок_NOUN
colorado_NOUN	колорадо_NOUN
save_VERB	сохранена_VERB
perth_NOUN	перт_NOUN
company_NOUN	компания_NOUN
common_ADJ	общий_ADJ
football_NOUN	футбол_NOUN
hall_NOUN	холл_NOUN
save_VERB	спасать_VERB
angel_NOUN	ангел_NOUN
cartoon_NOUN	мультик_NOUN
stanley_NOUN	стэнль_NOUN
arthur_NOUN	артура_NOUN
navigational_ADJ	навигационный_ADJ
explanation_NOUN	объяснение_NOUN
landscape_NOUN	пейзаж_NOUN
reserfe_NOUN	запас_NOUN
guard_NOUN	охрана_NOUN
width_NOUN	ширина_NOUN
israel_NOUN	израиль_NOUN
reject_VERB	отклонный_VERB
diocese_NOUN	епархия_NOUN
delete_VERB	удаленный_VERB
appeal_NOUN	призыв_NOUN
landmark_NOUN	ориентир_NOUN
gate_NOUN	ворот_NOUN
marvel_NOUN	чудо_NOUN
finnish_NOUN	финляндия_NOUN
key_ADJ	ключевой_ADJ
arena_NOUN	арена_NOUN
merge_NOUN	слияние_NOUN
brazil_NOUN	бразилие_NOUN
stage_NOUN	ступень_NOUN
try_VERB	стараться_VERB
intellectual_ADJ	интеллектуальный_ADJ
tea_NOUN	чай_NOUN
arkansa_NOUN	арканзас_NOUN
slightly_ADV	немного_ADV
chair_NOUN	председатель_NOUN
everything_PRON	все_PRON
walter_NOUN	уолтер_NOUN
slow_ADJ	медленный_ADJ
belt_NOUN	ремень_NOUN
card_NOUN	карта_NOUN
solution_NOUN	раствор_NOUN
mason_NOUN	мэйсона_NOUN
minor_ADJ	мелкий_ADJ
directory_NOUN	каталог_NOUN
rick_NOUN	рика_NOUN
also_ADV	также_ADV
university_NOUN	университет_NOUN
rarely_ADV	редко_ADV
ideal_ADJ	идеальный_ADJ
designation_NOUN	обозначение_NOUN
performance_NOUN	выступление_NOUN
mixing_NOUN	смешивание_NOUN
lot_NOUN	лот_NOUN
define_VERB	определять_VERB
accept_VERB	принимать_VERB
advice_NOUN	совет_NOUN
investment_NOUN	капиталовложение_NOUN
hire_VERB	нанимать_VERB
directory_NOUN	справочник_NOUN
century_NOUN	веко_NOUN
meet_VERB	знакомиться_VERB
pure_ADJ	чистый_ADJ
person_NOUN	человек_NOUN
permit_VERB	допускать_VERB
text_NOUN	текст_NOUN
market_NOUN	рынок_NOUN
contain_VERB	содержаться_VERB
constantly_ADV	постоянно_ADV
fame_NOUN	известность_NOUN
standings_NOUN	зачет_NOUN
right_ADV	правильный_ADV
viewer_NOUN	зритель_NOUN
pupil_NOUN	школьник_NOUN
françois_NOUN	франсуа_NOUN
human_NOUN	человек_NOUN
plan_VERB	планировать_VERB
code_NOUN	код_NOUN
accept_VERB	принять_VERB
ask_VERB	спрашивать_VERB
shift_NOUN	сдвиг_NOUN
handball_NOUN	гандбол_NOUN
illinois_NOUN	иллинойс_NOUN
order_NOUN	заказ_NOUN
bank_NOUN	банк_NOUN
perfectly_ADV	идеально_ADV
eagle_NOUN	ореть_NOUN
blue_ADJ	голубой_ADJ
dream_NOUN	сон_NOUN
will_AUX	быть_AUX
undo_NOUN	отмена_NOUN
chris_NOUN	криса_NOUN
punk_NOUN	панк_NOUN
stop_VERB	останавливаться_VERB
video_NOUN	видео_NOUN
girl_NOUN	девушка_NOUN
justin_NOUN	джастина_NOUN
dating_NOUN	знакомство_NOUN
uncle_NOUN	дядя_NOUN
treatment_NOUN	лечение_NOUN
card_NOUN	открытка_NOUN
sentence_NOUN	предложение_NOUN
impact_NOUN	влияние_NOUN
jay_NOUN	дж_NOUN
point_NOUN	точка_NOUN
laboratory_NOUN	лаборатория_NOUN
mother_NOUN	матушка_NOUN
third_ADJ	третий_ADJ
scale_NOUN	масштаб_NOUN
surround_VERB	окружать_VERB
cult_NOUN	культ_NOUN
charle_NOUN	шарль_NOUN
economic_ADJ	экономический_ADJ
malta_NOUN	мальт_NOUN
torpedo_NOUN	торпеда_NOUN
explain_VERB	объяснять_VERB
descent_NOUN	спуск_NOUN
principal_NOUN	директор_NOUN
utility_NOUN	полезность_NOUN
boss_NOUN	босс_NOUN
away_ADV	прочь_ADV
labor_NOUN	труд_NOUN
building_NOUN	здание_NOUN
branch_NOUN	филиал_NOUN
feed_NOUN	корм_NOUN
succession_NOUN	наследование_NOUN
crown_NOUN	корона_NOUN
sculpture_NOUN	скульптура_NOUN
shift_NOUN	смена_NOUN
house_NOUN	хаус_NOUN
inside_ADV	внутри_ADV
ownership_NOUN	владение_NOUN
animal_NOUN	животное_NOUN
retain_VERB	оставлять_VERB
house_NOUN	дом_NOUN
structure_NOUN	структура_NOUN
colombia_NOUN	колумбия_NOUN
publicly_ADV	публично_ADV
key_NOUN	ключ_NOUN
archive_NOUN	архив_NOUN
trip_NOUN	путешествие_NOUN
spiritual_ADJ	духовный_ADJ
continue_VERB	продолжать_VERB
least_ADV	мало_ADV
option_NOUN	опция_NOUN
parent_NOUN	родитель_NOUN
qualified_ADJ	квалифицировать_ADJ
front_NOUN	фронт_NOUN
pakistan_NOUN	пакистан_NOUN
narrow_ADJ	узкий_ADJ
initiative_NOUN	инициатива_NOUN
model_NOUN	модель_NOUN
river_NOUN	ривер_NOUN
magnetic_ADJ	магнитный_ADJ
monitoring_NOUN	мониторинг_NOUN
exchange_NOUN	биржа_NOUN
right_NOUN	право_NOUN
die_VERB	погибать_VERB
this_PRON	это_PRON
flight_NOUN	рейс_NOUN
think_VERB	подумать_VERB
daughter_NOUN	дочка_NOUN
shore_NOUN	берег_NOUN
farmer_NOUN	фермер_NOUN
employee_NOUN	работник_NOUN
robin_NOUN	робин_NOUN
dozen_NOUN	дюжина_NOUN
singe_VERB	петь_VERB
food_NOUN	продовольствие_NOUN
support_VERB	поддерживать_VERB
study_NOUN	изучение_NOUN
provide_VERB	обеспечивать_VERB
philadelphia_NOUN	филадельфия_NOUN
spring_NOUN	спрингс_NOUN
demonstrate_VERB	демонстрировать_VERB
concert_NOUN	концерт_NOUN
act_VERB	исполнять_VERB
tiny_ADJ	крошечный_ADJ
lat_NOUN	лат_NOUN
formal_ADJ	формальный_ADJ
surface_NOUN	поверхность_NOUN
service_NOUN	сервис_NOUN
withdrawn_VERB	снять_VERB
other_ADJ	другой_ADJ
extend_VERB	расширять_VERB
give_VERB	давать_VERB
reply_NOUN	ответ_NOUN
telephone_NOUN	телефон_NOUN
hero_NOUN	герой_NOUN
bright_ADJ	яркий_ADJ
back_VERB	поддерживать_VERB
terry_NOUN	терри_NOUN
city_NOUN	город_NOUN
data_NOUN	данные_NOUN
unable_ADJ	невозможный_ADJ
press_NOUN	печать_NOUN
louis_NOUN	луь_NOUN
netherland_NOUN	нидерланд_NOUN
worker_NOUN	работник_NOUN
collin_NOUN	коллинс_NOUN
identical_ADJ	идентичный_ADJ
ram_NOUN	рама_NOUN
hot_ADJ	горячий_ADJ
chester_NOUN	честер_NOUN
largest_ADJ	наибольший_ADJ
dennis_NOUN	деннис_NOUN
pattern_NOUN	шаблон_NOUN
intelligence_NOUN	разведка_NOUN
row_NOUN	ряд_NOUN
driver_NOUN	водитель_NOUN
successor_NOUN	преемник_NOUN
serve_VERB	подавать_VERB
entry_NOUN	запись_NOUN
princess_NOUN	принцесса_NOUN
author_NOUN	автор_NOUN
mayor_NOUN	мэр_NOUN
birth_NOUN	род_NOUN
male_NOUN	мужчина_NOUN
open_ADJ	открывать_ADJ
rival_NOUN	соперник_NOUN
rebellion_NOUN	мятеж_NOUN
departure_NOUN	отход_NOUN
ambassador_NOUN	посол_NOUN
reasonable_ADJ	разумный_ADJ
march_NOUN	март_NOUN
work_VERB	работать_VERB
bit_NOUN	бит_NOUN
lie_VERB	лежать_VERB
pan_NOUN	пэн_NOUN
john_NOUN	иоанн_NOUN
succeed_VERB	преуспевать_VERB
available_ADJ	доступно_ADJ
ground_NOUN	основание_NOUN
number_NOUN	количество_NOUN
sound_NOUN	звук_NOUN
settlement_NOUN	поселение_NOUN
rise_VERB	расти_VERB
celtic_ADJ	кельтский_ADJ
provide_VERB	предоставлять_VERB
mar_NOUN	марс_NOUN
pull_VERB	вытаскивать_VERB
robinson_NOUN	робинсона_NOUN
explanation_NOUN	разъяснение_NOUN
goal_NOUN	гол_NOUN
ten_NUM	десять_NUM
flash_NOUN	вспышка_NOUN
opponent_NOUN	противник_NOUN
deep_ADJ	глубокий_ADJ
tour_NOUN	экскурсия_NOUN
hugh_NOUN	хьюз_NOUN
killer_NOUN	убийца_NOUN
hill_NOUN	холм_NOUN
boat_NOUN	катер_NOUN
conspiracy_NOUN	заговор_NOUN
carrier_NOUN	носитель_NOUN
thing_NOUN	вещь_NOUN
cell_NOUN	камера_NOUN
audio_NOUN	звук_NOUN
liberal_ADJ	либеральный_ADJ
reject_VERB	отклонить_VERB
medicine_NOUN	лекарство_NOUN
management_NOUN	менеджмент_NOUN
send_VERB	отправлять_VERB
transfer_NOUN	перенос_NOUN
investigation_NOUN	расследование_NOUN
plaza_NOUN	плаз_NOUN
indeed_ADV	действительно_ADV
infrastructure_NOUN	инфраструктура_NOUN
protection_NOUN	защита_NOUN
attach_VERB	придавать_VERB
lodge_NOUN	ложе_NOUN
roosevelt_NOUN	рузвельт_NOUN
supplies_NOUN	поставка_NOUN
massacre_NOUN	резня_NOUN
need_NOUN	потребность_NOUN
decade_NOUN	десятилетие_NOUN
runner_NOUN	бегун_NOUN
treatment_NOUN	обращение_NOUN
dna_NOUN	днк_NOUN
approve_VERB	утверждать_VERB
mason_NOUN	мейсона_NOUN
specialist_NOUN	специалист_NOUN
vector_NOUN	вектор_NOUN
traffic_NOUN	движение_NOUN
vice_NOUN	вице_NOUN
once_ADV	однажды_ADV
real_ADJ	реальный_ADJ
secret_ADJ	секретный_ADJ
peace_NOUN	мир_NOUN
villa_NOUN	вилла_NOUN
money_NOUN	деньги_NOUN
armstrong_NOUN	армстронгать_NOUN
muhammad_NOUN	мухаммед_NOUN
philippine_NOUN	филиппина_NOUN
contain_VERB	сдерживать_VERB
landscape_NOUN	ландшафт_NOUN
worker_NOUN	рабочий_NOUN
nuclear_ADJ	ядерный_ADJ
consumption_NOUN	потребление_NOUN
available_ADJ	доступный_ADJ
begin_VERB	начинаться_VERB
pen_NOUN	ручка_NOUN
qualification_NOUN	квалификация_NOUN
incorrect_ADJ	неверно_ADJ
lose_VERB	проигрывать_VERB
instruction_NOUN	инструкция_NOUN
for_ADP	для_ADP
gradually_ADV	постепенно_ADV
cross_VERB	пересекать_VERB
wealth_NOUN	богатство_NOUN
account_NOUN	аккаунт_NOUN
condition_NOUN	условие_NOUN
notify_VERB	уведомить_VERB
well_NOUN	скважина_NOUN
all_DET	все_DET
offex_NOUN	офис_NOUN
hell_NOUN	ад_NOUN
allie_NOUN	союзник_NOUN
jordan_NOUN	иордание_NOUN
approval_NOUN	утверждение_NOUN
draw_VERB	рисовать_VERB
adopt_VERB	принимать_VERB
project_NOUN	проект_NOUN
ship_NOUN	судно_NOUN
bia_NOUN	предвзятость_NOUN
bombing_NOUN	взрыв_NOUN
beach_NOUN	пляж_NOUN
account_NOUN	аккаунвать_NOUN
physician_NOUN	врач_NOUN
hard_ADJ	трудный_ADJ
exist_VERB	существовать_VERB
build_VERB	строить_VERB
alive_ADJ	живой_ADJ
uniform_NOUN	форма_NOUN
official_ADJ	официальный_ADJ
point_NOUN	очко_NOUN
cup_NOUN	кубок_NOUN
mother_NOUN	матерь_NOUN
explain_VERB	пояснять_VERB
trad_VERB	обменять_VERB
expression_NOUN	выражение_NOUN
actor_NOUN	актер_NOUN
catch_VERB	попадаться_VERB
emotional_ADJ	эмоциональный_ADJ
ring_NOUN	кольцо_NOUN
harris_NOUN	харриса_NOUN
grade_NOUN	класс_NOUN
confusion_NOUN	замешательство_NOUN
commander_NOUN	командир_NOUN
candidate_NOUN	кандидат_NOUN
massive_ADJ	массовый_ADJ
arm_NOUN	оружие_NOUN
acceptable_ADJ	приемлемый_ADJ
leo_NOUN	лев_NOUN
functional_ADJ	функциональный_ADJ
psychological_ADJ	психологический_ADJ
property_NOUN	недвижимость_NOUN
teacher_NOUN	учитель_NOUN
slowly_ADV	медленно_ADV
inherit_VERB	унаследовать_VERB
identity_NOUN	самобытность_NOUN
bio_NOUN	биография_NOUN
weight_NOUN	вес_NOUN
kevin_NOUN	кевин_NOUN
partner_NOUN	напарник_NOUN
signal_NOUN	сигнал_NOUN
guy_NOUN	гай_NOUN
dead_ADJ	мертвый_ADJ
agency_NOUN	агентство_NOUN
central_ADJ	центральный_ADJ
carl_NOUN	карть_NOUN
register_VERB	регистрировать_VERB
composition_NOUN	композиция_NOUN
cash_NOUN	наличные_NOUN
pen_NOUN	пена_NOUN
headquarters_NOUN	штаб_NOUN
fair_ADJ	справедливый_ADJ
exclusively_ADV	исключительно_ADV
marathon_NOUN	марафон_NOUN
lebanon_NOUN	ливан_NOUN
admin_NOUN	администратор_NOUN
banner_NOUN	баннер_NOUN
entertainment_NOUN	развлечение_NOUN
tree_NOUN	дерево_NOUN
invite_VERB	приглашать_VERB
master_NOUN	мастерс_NOUN
horn_NOUN	рог_NOUN
restaurant_NOUN	ресторан_NOUN
take_VERB	взять_VERB
history_NOUN	история_NOUN
communication_NOUN	коммуникация_NOUN
name_NOUN	имя_NOUN
list_VERB	перечислять_VERB
straight_ADV	прямо_ADV
business_NOUN	предприятие_NOUN
test_NOUN	тест_NOUN
mon_NOUN	понедельник_NOUN
clay_NOUN	глина_NOUN
happen_VERB	происходить_VERB
suit_NOUN	костюм_NOUN
clinical_ADJ	клинический_ADJ
cost_NOUN	стоимость_NOUN
document_NOUN	документ_NOUN
veteran_NOUN	ветеран_NOUN
scottish_ADJ	шотландский_ADJ
lithuania_NOUN	литв_NOUN
print_VERB	печатать_VERB
lap_NOUN	круг_NOUN
personnel_NOUN	персонал_NOUN
go_VERB	ехать_VERB
mexican_ADJ	мексиканский_ADJ
factor_NOUN	коэффициент_NOUN
picture_NOUN	картинка_NOUN
refuse_VERB	отказываться_VERB
tennessee_NOUN	теннесси_NOUN
express_VERB	выразить_VERB
attempt_NOUN	покушение_NOUN
mind_NOUN	ум_NOUN
red_ADJ	красный_ADJ
southern_ADJ	южный_ADJ
difficultie_NOUN	трудность_NOUN
say_VERB	сказать_VERB
antarctican_NOUN	антарктика_NOUN
suspension_NOUN	приостановление_NOUN
request_VERB	запросить_VERB
critic_NOUN	критик_NOUN
police_NOUN	полицейский_NOUN
danger_NOUN	опасность_NOUN
loss_NOUN	убыток_NOUN
manufacturing_NOUN	производство_NOUN
ship_NOUN	корабль_NOUN
canyon_NOUN	каньон_NOUN
extension_NOUN	продление_NOUN
wrong_ADJ	неправильный_ADJ
shape_NOUN	форма_NOUN
temple_NOUN	храм_NOUN
frequent_ADJ	частый_ADJ
totally_ADV	полностью_ADV
slightly_ADV	слегка_ADV
renam_VERB	переименовывать_VERB
trip_NOUN	поездка_NOUN
opposition_NOUN	противостояние_NOUN
via_ADP	через_ADP
nearly_ADV	почти_ADV
make_NOUN	изготовление_NOUN
management_NOUN	управление_NOUN
plan_NOUN	планирование_NOUN
consumer_NOUN	потребитель_NOUN
remove_VERB	удалять_VERB
transport_NOUN	перевозка_NOUN
guide_NOUN	проводник_NOUN
horror_NOUN	ужас_NOUN
dublin_NOUN	дублина_NOUN
force_NOUN	сила_NOUN
apparently_ADV	видимо_ADV
jordan_NOUN	иордан_NOUN
racial_ADJ	расовый_ADJ
output_NOUN	выпуск_NOUN
health_NOUN	здоровье_NOUN
flight_NOUN	полет_NOUN
romance_NOUN	романтик_NOUN
phillip_NOUN	филлипс_NOUN
pilot_NOUN	пилот_NOUN
physic_NOUN	физик_NOUN
strange_ADJ	странный_ADJ
order_NOUN	приказ_NOUN
dec_NOUN	декабрь_NOUN
tank_NOUN	танк_NOUN
return_VERB	возвратить_VERB
complete_VERB	завершать_VERB
muhammad_NOUN	мухаммад_NOUN
round_NOUN	раунд_NOUN
therapy_NOUN	терапия_NOUN
nonsense_NOUN	чушь_NOUN
development_NOUN	развитие_NOUN
classification_NOUN	классификация_NOUN
employee_NOUN	сотрудник_NOUN
geography_NOUN	география_NOUN
literally_ADV	буквально_ADV
dam_NOUN	гэс_NOUN
track_NOUN	дорожка_NOUN
save_VERB	сохранять_VERB
foundation_NOUN	фонд_NOUN
go_VERB	пойти_VERB
performance_NOUN	исполнение_NOUN
league_NOUN	лига_NOUN
nearby_ADV	поблизости_ADV
outside_ADV	снаружи_ADV
context_NOUN	контекст_NOUN
destroy_VERB	уничтожать_VERB
choose_VERB	выбирать_VERB
miss_VERB	промахнуться_VERB
acoustic_ADJ	акустический_ADJ
classify_VERB	классифицировать_VERB
division_NOUN	подразделение_NOUN
health_NOUN	здравоохранение_NOUN
formally_ADV	официально_ADV
from_ADP	от_ADP
alice_NOUN	элис_NOUN
nomination_NOUN	выдвижение_NOUN
mar_NOUN	мар_NOUN
moore_NOUN	мур_NOUN
producer_NOUN	производитель_NOUN
consider_VERB	рассматривать_VERB
shield_NOUN	щит_NOUN
athen_NOUN	афины_NOUN
challenge_NOUN	вызов_NOUN
secure_VERB	обеспеченный_VERB
contact_NOUN	контакт_NOUN
tip_NOUN	подсказка_NOUN
limit_NOUN	ограничение_NOUN
attack_VERB	напасть_VERB
oldest_ADJ	старший_ADJ
instrument_NOUN	инструмент_NOUN
pine_NOUN	пайн_NOUN
association_NOUN	ассоциация_NOUN
professional_NOUN	профессионал_NOUN
dozen_NOUN	десяток_NOUN
basin_NOUN	бассейн_NOUN
previous_ADJ	предыдущий_ADJ
master_NOUN	мастер_NOUN
section_NOUN	раздел_NOUN
unknown_ADJ	неизвестный_ADJ
guitar_NOUN	гитара_NOUN
holder_NOUN	держатель_NOUN
warning_NOUN	предупреждение_NOUN
flag_NOUN	флаг_NOUN
typical_ADJ	типичный_ADJ
some_DET	некоторый_DET
director_NOUN	директор_NOUN
green_ADJ	зеленый_ADJ
mile_NOUN	майлз_NOUN
negotiation_NOUN	переговоры_NOUN
estonia_NOUN	эстония_NOUN
pedro_NOUN	педро_NOUN
capacity_NOUN	потенциал_NOUN
space_NOUN	пробел_NOUN
stand_VERB	стоить_VERB
cabinet_NOUN	кабинет_NOUN
succession_NOUN	преемственность_NOUN
revenge_NOUN	месть_NOUN
fortress_NOUN	крепость_NOUN
offer_VERB	предлагать_VERB
rank_NOUN	звание_NOUN
different_ADJ	различный_ADJ
compil_VERB	собирать_VERB
member_NOUN	участник_NOUN
door_NOUN	дверь_NOUN
beijing_NOUN	пекинска_NOUN
convict_VERB	осуждать_VERB
fat_NOUN	толстый_NOUN
cat_NOUN	кот_NOUN
rick_NOUN	рик_NOUN
read_NOUN	чтение_NOUN
castle_NOUN	касть_NOUN
become_VERB	становиться_VERB
squad_NOUN	отряд_NOUN
collapse_NOUN	крах_NOUN
unit_NOUN	единица_NOUN
light_NOUN	огонь_NOUN
promotion_NOUN	поощрение_NOUN
honour_NOUN	отличие_NOUN
programme_NOUN	программа_NOUN
together_ADV	вместе_ADV
searching_NOUN	поиск_NOUN
require_VERB	требоваться_VERB
largest_ADJ	крупный_ADJ
center_NOUN	центр_NOUN
artist_NOUN	исполнитель_NOUN
parish_NOUN	приход_NOUN
cost_NOUN	цена_NOUN
distribution_NOUN	распределение_NOUN
pan_NOUN	пан_NOUN
record_NOUN	запись_NOUN
dougla_NOUN	дуглас_NOUN
thing_NOUN	штука_NOUN
marketing_NOUN	сбыт_NOUN
finish_VERB	завершить_VERB
watson_NOUN	уотсон_NOUN
community_NOUN	сообщество_NOUN
trip_NOUN	трип_NOUN
launch_VERB	запустить_VERB
forever_ADV	вечно_ADV
standard_NOUN	стандартный_NOUN
jerry_NOUN	джерри_NOUN
marine_NOUN	морской_NOUN
ray_NOUN	рэй_NOUN
arrival_NOUN	прибытие_NOUN
people_NOUN	народ_NOUN
custom_NOUN	таможня_NOUN
politics_NOUN	политика_NOUN
dominican_ADJ	доминиканская_ADJ
parallel_NOUN	параллель_NOUN
timeline_NOUN	хроника_NOUN
prayer_NOUN	молитва_NOUN
exhibit_NOUN	выставка_NOUN
palestinian_ADJ	палестинский_ADJ
leo_NOUN	лео_NOUN
interest_NOUN	заинтересованность_NOUN
stage_NOUN	этап_NOUN
tower_NOUN	башня_NOUN
inner_ADJ	внутренний_ADJ
instrument_NOUN	прибор_NOUN
hole_NOUN	дырка_NOUN
hear_NOUN	слушание_NOUN
absolutely_ADV	абсолютно_ADV
fund_VERB	финансировать_VERB
autonomous_ADJ	автономный_ADJ
cancer_NOUN	рак_NOUN
activity_NOUN	мероприятие_NOUN
campbell_NOUN	кэмпбелла_NOUN
annually_ADV	ежегодно_ADV
situation_NOUN	ситуация_NOUN
belief_NOUN	убеждение_NOUN
axis_NOUN	ось_NOUN
fifth_NOUN	пятый_NOUN
evidence_NOUN	улика_NOUN
various_ADJ	различный_ADJ
restoration_NOUN	восстановление_NOUN
cuba_NOUN	кубо_NOUN
allegation_NOUN	утверждение_NOUN
potential_NOUN	потенциальный_NOUN
vincent_NOUN	винсенть_NOUN
dual_ADJ	двойной_ADJ
price_NOUN	цена_NOUN
expand_VERB	расширять_VERB
bird_NOUN	птичка_NOUN
device_NOUN	устройство_NOUN
ball_NOUN	мяч_NOUN
trail_NOUN	след_NOUN
work_VERB	срабатывать_VERB
care_NOUN	забота_NOUN
touch_NOUN	прикосновение_NOUN
guidance_NOUN	руководство_NOUN
interest_NOUN	процент_NOUN
historic_ADJ	исторический_ADJ
prefecture_NOUN	префектура_NOUN
game_NOUN	игра_NOUN
gross_ADJ	валовой_ADJ
asia_NOUN	азия_NOUN
report_NOUN	отчет_NOUN
tag_NOUN	метка_NOUN
end_NOUN	конец_NOUN
poem_NOUN	стихотворение_NOUN
accessible_ADJ	доступный_ADJ
unsuccessful_ADJ	безуспешный_ADJ
knowledge_NOUN	знание_NOUN
dry_NOUN	сухой_NOUN
gray_NOUN	серый_NOUN
fox_NOUN	лиса_NOUN
return_NOUN	возвращение_NOUN
alliance_NOUN	альянс_NOUN
need_VERB	требоваться_VERB
albania_NOUN	албание_NOUN
impact_NOUN	результативность_NOUN
roster_NOUN	реестр_NOUN
adult_NOUN	взрослый_NOUN
creek_NOUN	крик_NOUN
tunnel_NOUN	тоннель_NOUN
construction_NOUN	строительство_NOUN
solomon_NOUN	оломоть_NOUN
speak_VERB	выступать_VERB
ukraine_NOUN	украин_NOUN
lgbt_NOUN	лгбть_NOUN
catherine_NOUN	екатерина_NOUN
display_VERB	показывать_VERB
title_VERB	озаглавливать_VERB
catherine_NOUN	катрин_NOUN
attack_VERB	атаковать_VERB
egg_NOUN	яйцо_NOUN
jamaican_NOUN	ямайки_NOUN
baronet_NOUN	барогать_NOUN
anonymous_ADJ	анонимный_ADJ
reduction_NOUN	сокращение_NOUN
heavy_ADJ	тяжелый_ADJ
galaxy_NOUN	галактика_NOUN
touring_NOUN	гастроль_NOUN
often_ADV	нередко_ADV
root_NOUN	корень_NOUN
deny_VERB	отклонить_VERB
olympic_ADJ	олимпийский_ADJ
military_ADJ	военный_ADJ
establishment_NOUN	заведение_NOUN
survive_VERB	переживать_VERB
suggestion_NOUN	предложение_NOUN
submit_VERB	представлять_VERB
mouse_NOUN	мышка_NOUN
draft_NOUN	черновик_NOUN
death_NOUN	смерть_NOUN
mix_NOUN	микс_NOUN
factor_NOUN	фактор_NOUN
coast_NOUN	берег_NOUN
case_NOUN	случай_NOUN
enterprise_NOUN	предприятие_NOUN
between_ADP	между_ADP
harbour_NOUN	харбор_NOUN
picture_NOUN	фотка_NOUN
wear_VERB	носить_VERB
replace_VERB	заменять_VERB
doctrine_NOUN	доктрина_NOUN
rebel_NOUN	мятежник_NOUN
wood_NOUN	дрова_NOUN
peter_NOUN	петр_NOUN
bombing_NOUN	бомбардировка_NOUN
yellow_ADJ	желтый_ADJ
guinea_NOUN	гвиней_NOUN
hidden_VERB	скрывать_VERB
program_NOUN	программа_NOUN
far_ADV	далеко_ADV
fauna_NOUN	фауна_NOUN
rest_VERB	отдохнуть_VERB
celebrity_NOUN	знаменитость_NOUN
corner_NOUN	угол_NOUN
devon_NOUN	девон_NOUN
attendance_NOUN	присутствие_NOUN
move_VERB	переезжать_VERB
han_NOUN	ганс_NOUN
hat_NOUN	шляпа_NOUN
publisher_NOUN	издательство_NOUN
chorus_NOUN	хор_NOUN
friendship_NOUN	дружба_NOUN
militia_NOUN	милиция_NOUN
conventional_ADJ	обычный_ADJ
domain_NOUN	домна_NOUN
mary_NOUN	мария_NOUN
day_NOUN	день_NOUN
india_NOUN	индия_NOUN
evan_NOUN	эванс_NOUN
stop_VERB	прекращать_VERB
eagle_NOUN	орел_NOUN
washington_NOUN	вашингтон_NOUN
occupy_VERB	оккупировать_VERB
obtain_VERB	получать_VERB
flight_NOUN	перелет_NOUN
say_VERB	говорить_VERB
demolish_VERB	разрушать_VERB
respect_NOUN	уважение_NOUN
new_ADJ	новый_ADJ
increase_NOUN	увеличение_NOUN
view_NOUN	мнение_NOUN
victoria_NOUN	виктория_NOUN
content_NOUN	содержание_NOUN
ignore_VERB	игнорировать_VERB
diplomatic_ADJ	дипломатическая_ADJ
chase_NOUN	погоня_NOUN
novelist_NOUN	писатель_NOUN
explanation_NOUN	пояснение_NOUN
propaganda_NOUN	пропаганда_NOUN
internet_NOUN	интернет_NOUN
murphy_NOUN	мерфь_NOUN
medical_ADJ	медицинский_ADJ
venezuela_NOUN	венесуэл_NOUN
accuracy_NOUN	точность_NOUN
matt_NOUN	мэть_NOUN
title_NOUN	название_NOUN
anne_NOUN	анна_NOUN
concentration_NOUN	сосредоточение_NOUN
help_VERB	помогать_VERB
congregation_NOUN	конгрегация_NOUN
power_NOUN	сила_NOUN
bird_NOUN	птица_NOUN
characterize_VERB	характеризовать_VERB
serial_ADJ	последовательный_ADJ
industry_NOUN	промышленность_NOUN
disney_NOUN	дисня_NOUN
training_NOUN	обучение_NOUN
before_ADV	прежде_ADV
bridge_NOUN	мостик_NOUN
note_VERB	отмечать_VERB
property_NOUN	собственность_NOUN
garrison_NOUN	гаррисон_NOUN
era_NOUN	эра_NOUN
summer_NOUN	саммерый_NOUN
hit_VERB	ударять_VERB
loss_NOUN	потеря_NOUN
lawrence_NOUN	лоуренс_NOUN
metre_NOUN	метр_NOUN
gary_NOUN	гэри_NOUN
india_NOUN	индий_NOUN
beach_NOUN	бич_NOUN
interested_ADJ	заинтересованный_ADJ
collect_VERB	собирать_VERB
merger_NOUN	слияние_NOUN
flag_NOUN	флажок_NOUN
suitable_ADJ	подходить_ADJ
gregory_NOUN	григорий_NOUN
review_NOUN	отзыв_NOUN
press_NOUN	пресса_NOUN
permanent_ADJ	постоянный_ADJ
durham_NOUN	даирать_NOUN
component_NOUN	компонент_NOUN
immediately_ADV	немедленно_ADV
prepared_VERB	подготавливать_VERB
inhabitant_NOUN	обитатель_NOUN
prisoner_NOUN	заключенный_NOUN
safe_ADJ	безопасный_ADJ
ill_ADJ	больной_ADJ
favor_NOUN	услуга_NOUN
grandson_NOUN	внук_NOUN
citizenship_NOUN	гражданство_NOUN
chair_NOUN	кресло_NOUN
simpson_NOUN	импсоть_NOUN
suggest_VERB	предлагать_VERB
ball_NOUN	шар_NOUN
administration_NOUN	администрация_NOUN
mercury_NOUN	ртуть_NOUN
motion_NOUN	ходатайство_NOUN
deck_NOUN	палуба_NOUN
grant_NOUN	грант_NOUN
payment_NOUN	выплата_NOUN
turkey_NOUN	индейка_NOUN
archbishop_NOUN	архиепископ_NOUN
skill_NOUN	навык_NOUN
disease_NOUN	заболевание_NOUN
event_NOUN	событие_NOUN
honorary_ADJ	почетный_ADJ
capable_ADJ	способный_ADJ
herbert_NOUN	герберт_NOUN
lady_NOUN	леди_NOUN
cole_NOUN	коул_NOUN
photographer_NOUN	фотограф_NOUN
rebound_NOUN	подбор_NOUN
almost_ADV	практически_ADV
rider_NOUN	всадник_NOUN
review_NOUN	рассмотрение_NOUN
aerial_ADJ	воздушный_ADJ
easy_ADJ	легкий_ADJ
governor_NOUN	губернатор_NOUN
guard_NOUN	охранник_NOUN
main_ADJ	основной_ADJ
debt_NOUN	задолженность_NOUN
multiple_ADJ	множественный_ADJ
enter_VERB	вступать_VERB
destroy_VERB	разрушать_VERB
romania_NOUN	румыние_NOUN
rear_ADJ	задний_ADJ
johnny_NOUN	джоннь_NOUN
layer_NOUN	слой_NOUN
finishing_NOUN	окончание_NOUN
taste_NOUN	вкус_NOUN
normally_ADV	обычно_ADV
monitoring_NOUN	наблюдение_NOUN
coup_NOUN	переворот_NOUN
value_NOUN	величина_NOUN
precede_VERB	предшествовать_VERB
farming_NOUN	земледелие_NOUN
removal_NOUN	удаление_NOUN
defender_NOUN	защитник_NOUN
milk_NOUN	молоко_NOUN
societie_NOUN	общество_NOUN
wish_VERB	желать_VERB
spencer_NOUN	спенсер_NOUN
appropriate_ADJ	соответствующий_ADJ
chief_NOUN	начальник_NOUN
tourist_NOUN	турист_NOUN
gabriel_NOUN	габриэль_NOUN
delivery_NOUN	доставка_NOUN
window_NOUN	окно_NOUN
earn_NOUN	заработок_NOUN
right_ADV	вправо_ADV
facility_NOUN	объект_NOUN
environmental_ADJ	экологический_ADJ
county_NOUN	графств_NOUN
morning_NOUN	утро_NOUN
pupil_NOUN	ученик_NOUN
eliminate_VERB	устранить_VERB
jefferson_NOUN	джефферсона_NOUN
probably_ADV	вероятно_ADV
king_NOUN	царь_NOUN
put_VERB	ставить_VERB
maybe_ADV	возможный_ADV
twice_ADV	дважды_ADV
extend_VERB	расширить_VERB
angle_NOUN	угол_NOUN
subsequent_ADJ	последующий_ADJ
manage_VERB	управлять_VERB
bull_NOUN	бык_NOUN
square_NOUN	квадрат_NOUN
trust_NOUN	доверие_NOUN
recurr_VERB	повторяться_VERB
independently_ADV	самостоятельно_ADV
keith_NOUN	кит_NOUN
attend_VERB	присутствовать_VERB
defense_NOUN	защита_NOUN
researcher_NOUN	исследователь_NOUN
concept_NOUN	понятие_NOUN
car_NOUN	вагон_NOUN
domestic_ADJ	внутренний_ADJ
rating_NOUN	рейтинг_NOUN
aviation_NOUN	авиация_NOUN
william_NOUN	уильямс_NOUN
benefit_NOUN	льгота_NOUN
burn_NOUN	бернс_NOUN
adam_NOUN	адамс_NOUN
request_NOUN	запрос_NOUN
concentration_NOUN	концентрация_NOUN
min_NOUN	минута_NOUN
ballet_NOUN	балет_NOUN
professor_NOUN	преподаватель_NOUN
grant_VERB	предоставлять_VERB
thick_ADJ	толстый_ADJ
vote_NOUN	голос_NOUN
integration_NOUN	интеграция_NOUN
philosophical_ADJ	философский_ADJ
penalty_NOUN	наказание_NOUN
foundation_NOUN	основа_NOUN
nine_NUM	девять_NUM
famous_ADJ	известный_ADJ
remember_VERB	помнить_VERB
remainder_NOUN	остаток_NOUN
desk_NOUN	стол_NOUN
player_NOUN	проигрыватель_NOUN
wrong_ADJ	неверно_ADJ
river_NOUN	река_NOUN
casualty_NOUN	потеря_NOUN
cover_NOUN	покрытие_NOUN
core_NOUN	ядро_NOUN
print_NOUN	печать_NOUN
plastic_ADJ	пластиковый_ADJ
power_NOUN	власть_NOUN
testament_NOUN	завещание_NOUN
group_NOUN	группа_NOUN
trading_NOUN	торговля_NOUN
mad_ADJ	безумная_ADJ
entry_NOUN	въезд_NOUN
bury_VERB	хоронить_VERB
control_VERB	контролировать_VERB
addition_NOUN	дополнение_NOUN
bone_NOUN	кость_NOUN
venice_NOUN	венеция_NOUN
animation_NOUN	анимация_NOUN
charity_NOUN	благотворительность_NOUN
fellowship_NOUN	стипендия_NOUN
universal_ADJ	универсальный_ADJ
revival_NOUN	оживление_NOUN
manuscript_NOUN	рукопись_NOUN
cup_NOUN	чаша_NOUN
standard_NOUN	стандарт_NOUN
minister_NOUN	министр_NOUN
residential_ADJ	жилой_ADJ
competitive_ADJ	конкурсный_ADJ
arrangement_NOUN	договоренность_NOUN
november_NOUN	ноябрь_NOUN
cambridge_NOUN	кембридж_NOUN
newport_NOUN	ньюпорт_NOUN
medal_NOUN	медаль_NOUN
rationale_NOUN	обоснование_NOUN
advisory_ADJ	консультативный_ADJ
directory_NOUN	папка_NOUN
definitely_ADV	однозначно_ADV
advanced_ADJ	передовой_ADJ
recognition_NOUN	признание_NOUN
adaptation_NOUN	адаптация_NOUN
peter_NOUN	пётр_NOUN
coverage_NOUN	охват_NOUN
june_NOUN	июнь_NOUN
transportation_NOUN	транспортировка_NOUN
hunt_NOUN	ханть_NOUN
many_ADJ	многие_ADJ
officially_ADV	официально_ADV
theatre_NOUN	театр_NOUN
monthly_ADJ	месячный_ADJ
sugar_NOUN	сахар_NOUN
transportation_NOUN	транспорт_NOUN
teaching_NOUN	обучение_NOUN
wood_NOUN	древесина_NOUN
wine_NOUN	вино_NOUN
quote_VERB	процитировать_VERB
atomic_ADJ	атомный_ADJ
detail_NOUN	деталь_NOUN
fashion_NOUN	модный_NOUN
fighting_NOUN	бой_NOUN
mr_NOUN	миссис_NOUN
praise_VERB	хвалить_VERB
moscow_NOUN	москво_NOUN
truth_NOUN	истина_NOUN
provincial_ADJ	провинциальный_ADJ
check_VERB	проверять_VERB
name_VERB	называть_VERB
task_NOUN	задание_NOUN
society_NOUN	общество_NOUN
not_PART	не_PART
people_NOUN	человек_NOUN
image_NOUN	изображение_NOUN
philippine_NOUN	филиппин_NOUN
colombia_NOUN	колумбие_NOUN
attitude_NOUN	отношение_NOUN
lawyer_NOUN	юрист_NOUN
newton_NOUN	ньютон_NOUN
equivalent_ADJ	эквивалентный_ADJ
timber_NOUN	древесина_NOUN
think_VERB	думать_VERB
away_ADV	далеко_ADV
canadian_ADJ	канадский_ADJ
training_NOUN	подготовка_NOUN
heat_NOUN	тепло_NOUN
battery_NOUN	аккумулятор_NOUN
creator_NOUN	творец_NOUN
patient_NOUN	пациент_NOUN
frequency_NOUN	частотность_NOUN
pioneer_NOUN	пионер_NOUN
scope_NOUN	охват_NOUN
edward_NOUN	эдвардс_NOUN
eagles_NOUN	орел_NOUN
french_ADJ	французский_ADJ
resolution_NOUN	резолюция_NOUN
able_ADJ	способный_ADJ
object_NOUN	объект_NOUN
evil_NOUN	зло_NOUN
call_NOUN	вызов_NOUN
transmission_NOUN	передача_NOUN
warsaw_NOUN	варшава_NOUN
excellence_NOUN	совершенство_NOUN
criminal_ADJ	преступный_ADJ
feature_VERB	избирать_VERB
conversation_NOUN	беседа_NOUN
cinema_NOUN	кино_NOUN
hip_NOUN	хип_NOUN
belong_VERB	принадлежать_VERB
fourth_NOUN	четвертый_NOUN
circumstance_NOUN	обстоятельство_NOUN
smaller_ADJ	мало_ADJ
typically_ADV	обычно_ADV
ways_NOUN	путь_NOUN
beat_VERB	побеждать_VERB
feature_VERB	выделять_VERB
delta_NOUN	дельта_NOUN
campaign_NOUN	кампания_NOUN
post_VERB	разместить_VERB
wall_NOUN	стена_NOUN
sell_VERB	продавать_VERB
edge_NOUN	край_NOUN
hampshire_NOUN	хэмпшир_NOUN
conversion_NOUN	конверсия_NOUN
recovery_NOUN	восстановление_NOUN
optional_ADJ	факультативный_ADJ
literature_NOUN	литература_NOUN
tape_NOUN	лента_NOUN
irish_ADJ	ирландский_ADJ
hong_NOUN	хун_NOUN
theme_NOUN	тема_NOUN
delete_VERB	удалять_VERB
pass_NOUN	пас_NOUN
attack_NOUN	нападки_NOUN
charge_VERB	взимать_VERB
brick_NOUN	брика_NOUN
florence_NOUN	флоренция_NOUN
victory_NOUN	победа_NOUN
preserve_VERB	сохранять_VERB
leave_VERB	уходить_VERB
sale_NOUN	распродажа_NOUN
voice_VERB	выражать_VERB
brother_NOUN	брат_NOUN
brook_NOUN	брукс_NOUN
dennis_NOUN	дэннис_NOUN
sir_NOUN	сэр_NOUN
roman_NOUN	роман_NOUN
celebration_NOUN	празднование_NOUN
congress_NOUN	съезд_NOUN
disorder_NOUN	расстройство_NOUN
risk_NOUN	риск_NOUN
believe_VERB	верить_VERB
try_VERB	пытаться_VERB
choir_NOUN	хор_NOUN
national_ADJ	национальный_ADJ
chance_NOUN	шанс_NOUN
vehicle_NOUN	автомобиль_NOUN
flower_NOUN	цветочек_NOUN
equation_NOUN	уравнение_NOUN
variety_NOUN	разнообразие_NOUN
mines_NOUN	мина_NOUN
commander_NOUN	коммандер_NOUN
legal_ADJ	правовой_ADJ
block_VERB	блокировать_VERB
barbara_NOUN	барбара_NOUN
half_NOUN	половина_NOUN
plot_NOUN	сюжет_NOUN
radical_ADJ	радикальный_ADJ
audience_NOUN	аудитория_NOUN
atmosphere_NOUN	атмосфера_NOUN
winter_NOUN	винтер_NOUN
metal_NOUN	метать_NOUN
capacity_NOUN	способность_NOUN
stuff_NOUN	вещь_NOUN
critic_NOUN	критика_NOUN
command_NOUN	команда_NOUN
column_NOUN	колонка_NOUN
count_NOUN	граф_NOUN
baron_NOUN	барон_NOUN
prince_NOUN	князь_NOUN
junior_ADJ	младший_ADJ
benefit_NOUN	выгода_NOUN
pupil_NOUN	зрачок_NOUN
warrant_NOUN	ордер_NOUN
pain_NOUN	боль_NOUN
hospital_NOUN	больница_NOUN
field_NOUN	поле_NOUN
walker_NOUN	уолкер_NOUN
derby_NOUN	дерби_NOUN
ronald_NOUN	рональд_NOUN
mix_VERB	смешанный_VERB
chapter_NOUN	глава_NOUN
religion_NOUN	религия_NOUN
election_NOUN	избрание_NOUN
dave_NOUN	дэйв_NOUN
rifle_NOUN	винтовка_NOUN
protest_NOUN	протест_NOUN
problem_NOUN	проблема_NOUN
seattle_NOUN	сиэтл_NOUN
income_NOUN	доход_NOUN
nature_NOUN	природа_NOUN
attraction_NOUN	достопримечательность_NOUN
queen_NOUN	куин_NOUN
purchase_NOUN	покупка_NOUN
audio_NOUN	аудио_NOUN
caribbean_ADJ	карибской_ADJ
commerce_NOUN	торговля_NOUN
childhood_NOUN	детство_NOUN
commissioner_NOUN	уполномоченный_NOUN
block_NOUN	блок_NOUN
philip_NOUN	филлип_NOUN
geographical_ADJ	географический_ADJ
bath_NOUN	бить_NOUN
ban_NOUN	бывать_NOUN
partner_NOUN	партнер_NOUN
break_VERB	ломаться_VERB
function_NOUN	функция_NOUN
argument_NOUN	аргумент_NOUN
maria_NOUN	мария_NOUN
harbour_NOUN	гавань_NOUN
understand_VERB	понимать_VERB
article_NOUN	статья_NOUN
field_NOUN	филд_NOUN
item_NOUN	предмет_NOUN
album_NOUN	альбом_NOUN
effect_NOUN	последствие_NOUN
skin_NOUN	кожа_NOUN
phoenix_NOUN	феникс_NOUN
phase_NOUN	стадия_NOUN
son_NOUN	сын_NOUN
authority_NOUN	авторитет_NOUN
lead_NOUN	свинец_NOUN
rating_NOUN	оценка_NOUN
agricultural_ADJ	сельскохозяйственный_ADJ
participate_VERB	участвовать_VERB
bibliography_NOUN	библиография_NOUN
anniversary_NOUN	юбилей_NOUN
foreign_ADJ	иностранный_ADJ
remote_ADJ	дистанционный_ADJ
leave_VERB	оставаться_VERB
later_ADV	поздно_ADV
follow_VERB	следовать_VERB
taylor_NOUN	тейлор_NOUN
storage_NOUN	хранение_NOUN
suspect_VERB	подозревать_VERB
mad_ADJ	бешеный_ADJ
part_NOUN	часть_NOUN
concern_NOUN	обеспокоенность_NOUN
achievement_NOUN	достижение_NOUN
denver_NOUN	денвер_NOUN
otherwise_ADV	иначе_ADV
partially_ADV	отчасти_ADV
state_VERB	заявлять_VERB
uncle_NOUN	дядюшка_NOUN
cylinder_NOUN	баллон_NOUN
theater_NOUN	кинотеатр_NOUN
winter_NOUN	зима_NOUN
girl_NOUN	девчонка_NOUN
identical_ADJ	одинаковый_ADJ
switch_NOUN	переключатель_NOUN
dome_NOUN	купол_NOUN
branch_NOUN	отрасль_NOUN
jan_NOUN	янин_NOUN
illness_NOUN	болезнь_NOUN
assistant_NOUN	помощник_NOUN
contemporary_ADJ	современный_ADJ
script_NOUN	сценарий_NOUN
steve_NOUN	стив_NOUN
primary_ADJ	первичный_ADJ
russia_NOUN	россие_NOUN
solomon_NOUN	соломон_NOUN
bronze_NOUN	бронза_NOUN
yale_NOUN	йель_NOUN
friendly_ADJ	дружеский_ADJ
makeup_NOUN	косметика_NOUN
missionary_NOUN	миссионер_NOUN
disease_NOUN	болезнь_NOUN
murder_NOUN	убийство_NOUN
plot_NOUN	участок_NOUN
promotion_NOUN	продвижение_NOUN
mining_NOUN	добыча_NOUN
nearby_ADV	рядом_ADV
baseball_NOUN	бейсбол_NOUN
totally_ADV	абсолютно_ADV
value_NOUN	ценность_NOUN
inch_NOUN	дюйм_NOUN
object_NOUN	предмет_NOUN
fellowship_NOUN	братство_NOUN
above_ADV	высоко_ADV
hall_NOUN	зал_NOUN
catholic_ADJ	католический_ADJ
incident_NOUN	инцидент_NOUN
classic_ADJ	классический_ADJ
creator_NOUN	создатель_NOUN
crowd_NOUN	толпа_NOUN
report_VERB	сообщать_VERB
visitor_NOUN	посетитель_NOUN
charge_NOUN	обвинение_NOUN
challenge_NOUN	задача_NOUN
read_VERB	читать_VERB
contribution_NOUN	взнос_NOUN
give_VERB	учитывать_VERB
doubles_NOUN	двойник_NOUN
rhythm_NOUN	ритм_NOUN
malta_NOUN	мальта_NOUN
letter_NOUN	письмо_NOUN
nearby_ADV	неподалеку_ADV
centre_NOUN	центр_NOUN
location_NOUN	расположение_NOUN
activist_NOUN	активист_NOUN
wood_NOUN	вуд_NOUN
company_NOUN	рота_NOUN
platform_NOUN	платформа_NOUN
marie_NOUN	мари_NOUN
lebanon_NOUN	ливать_NOUN
pitcher_NOUN	питчер_NOUN
hurricane_NOUN	ураган_NOUN
response_NOUN	ответ_NOUN
motor_NOUN	мотор_NOUN
syrian_ADJ	сирийский_ADJ
negative_ADJ	негативный_ADJ
completely_ADV	совершенно_ADV
mines_NOUN	минута_NOUN
certificate_NOUN	справка_NOUN
restore_VERB	восстанавливать_VERB
wolf_NOUN	волк_NOUN
voyage_NOUN	рейс_NOUN
bird_NOUN	бёрд_NOUN
clark_NOUN	кларк_NOUN
burn_VERB	гореть_VERB
generation_NOUN	поколение_NOUN
issue_VERB	выпускать_VERB
where_ADV	куда_ADV
visible_ADJ	видный_ADJ
approach_NOUN	подход_NOUN
agency_NOUN	учреждение_NOUN
congress_NOUN	конгресс_NOUN
cinema_NOUN	кинотеатр_NOUN
form_VERB	сформировывать_VERB
insect_NOUN	насекомое_NOUN
simultaneously_ADV	одновременно_ADV
professional_NOUN	специалист_NOUN
watch_VERB	смотреть_VERB
europe_NOUN	европа_NOUN
guy_NOUN	ги_NOUN
annual_ADJ	ежегодный_ADJ
francis_NOUN	франциск_NOUN
originally_ADV	изначально_ADV
seven_NUM	семь_NUM
todd_NOUN	тодд_NOUN
agency_NOUN	агенств_NOUN
thoma_NOUN	томас_NOUN
norwegian_ADJ	норвежский_ADJ
colony_NOUN	колония_NOUN
fairly_ADV	справедливо_ADV
son_NOUN	сынок_NOUN
benefit_NOUN	пособие_NOUN
update_VERB	обновлять_VERB
space_NOUN	пространство_NOUN
contest_NOUN	конкурс_NOUN
way_NOUN	путь_NOUN
specify_VERB	указывать_VERB
statement_NOUN	заявление_NOUN
virtual_ADJ	виртуальный_ADJ
private_ADJ	личный_ADJ
hold_VERB	проводить_VERB
hour_NOUN	час_NOUN
split_VERB	разделять_VERB
post_NOUN	пост_NOUN
click_VERB	нажать_VERB
hungarian_ADJ	венгерский_ADJ
round_NOUN	обход_NOUN
difficulty_NOUN	сложность_NOUN
goalkeeper_NOUN	вратарь_NOUN
serbia_NOUN	сербие_NOUN
image_NOUN	имидж_NOUN
read_VERB	прочитывать_VERB
offensive_NOUN	наступление_NOUN
crisis_NOUN	кризис_NOUN
bear_NOUN	мишка_NOUN
painting_NOUN	картина_NOUN
concrete_NOUN	бетон_NOUN
load_NOUN	нагрузка_NOUN
stockholm_NOUN	стокголм_NOUN
minnesota_NOUN	миннесота_NOUN
frame_NOUN	рамка_NOUN
asian_ADJ	азиатский_ADJ
prominent_ADJ	видный_ADJ
child_NOUN	ребенок_NOUN
nomination_NOUN	назначение_NOUN
goal_NOUN	цель_NOUN
simon_NOUN	имоть_NOUN
permanent_ADJ	постоянная_ADJ
earthquake_NOUN	землетрясение_NOUN
monitoring_NOUN	контроль_NOUN
florence_NOUN	флоренс_NOUN
fighter_NOUN	боец_NOUN
extensive_ADJ	обширный_ADJ
speaker_NOUN	спикер_NOUN
championship_NOUN	чемпионат_NOUN
language_NOUN	язык_NOUN
boat_NOUN	лодка_NOUN
cargo_NOUN	груз_NOUN
molecular_ADJ	молекулярный_ADJ
comment_NOUN	комментарий_NOUN
automatically_ADV	автоматически_ADV
die_VERB	умирать_VERB
ownership_NOUN	собственность_NOUN
clothing_NOUN	одежда_NOUN
area_NOUN	район_NOUN
star_NOUN	старый_NOUN
storage_NOUN	склад_NOUN
bath_NOUN	ванная_NOUN
heat_NOUN	теплокоммуникация_NOUN
debt_NOUN	долг_NOUN
supply_NOUN	снабжение_NOUN
coat_NOUN	пальто_NOUN
dog_NOUN	пес_NOUN
draft_NOUN	проект_NOUN
last_ADJ	последний_ADJ
indianapolis_NOUN	индианаполис_NOUN
term_NOUN	условие_NOUN
install_VERB	устанавливать_VERB
tie_NOUN	ничья_NOUN
ratio_NOUN	соотношение_NOUN
federation_NOUN	федерация_NOUN
post_NOUN	должность_NOUN
president_NOUN	председатель_NOUN
expect_VERB	ожидать_VERB
action_NOUN	акция_NOUN
really_ADV	действительно_ADV
feature_NOUN	функция_NOUN
horse_NOUN	конь_NOUN
graduate_NOUN	выпускник_NOUN
mobile_ADJ	мобильный_ADJ
strip_NOUN	стрип_NOUN
guest_NOUN	гость_NOUN
announce_VERB	объявить_VERB
upload_VERB	загрузить_VERB
limit_NOUN	предел_NOUN
serbian_ADJ	сербский_ADJ
jun_NOUN	чжун_NOUN
cooperation_NOUN	сотрудничество_NOUN
apple_NOUN	яблоко_NOUN
alternative_NOUN	альтернатива_NOUN
input_NOUN	вклад_NOUN
immigrant_NOUN	иммигрант_NOUN
knight_NOUN	рыцарь_NOUN
apartment_NOUN	апартамент_NOUN
matter_NOUN	материя_NOUN
giant_ADJ	гигантский_ADJ
tax_NOUN	налог_NOUN
independence_NOUN	независимость_NOUN
technique_NOUN	техника_NOUN
academy_NOUN	академия_NOUN
award_VERB	награждать_VERB
behavior_NOUN	поведение_NOUN
environment_NOUN	окружение_NOUN
biblical_ADJ	библейский_ADJ
outcome_NOUN	итог_NOUN
luca_NOUN	лукас_NOUN
subject_NOUN	тема_NOUN
cancel_VERB	отменять_VERB
sierra_NOUN	сьерр_NOUN
joseph_NOUN	джозеф_NOUN
sentence_VERB	приговаривать_VERB
freestyle_NOUN	фристайл_NOUN
kansa_NOUN	канзас_NOUN
fall_VERB	падать_VERB
area_NOUN	область_NOUN
night_NOUN	ночь_NOUN
target_NOUN	цель_NOUN
gene_NOUN	ген_NOUN
run_VERB	бежать_VERB
shopping_NOUN	покупка_NOUN
completely_ADV	полностью_ADV
household_NOUN	домохозяйство_NOUN
selection_NOUN	подборка_NOUN
reform_NOUN	реформирование_NOUN
spouse_NOUN	супруга_NOUN
boulevard_NOUN	бульвар_NOUN
complete_ADJ	полный_ADJ
capture_VERB	захватывать_VERB
watch_VERB	наблюдать_VERB
turner_NOUN	тернер_NOUN
rider_NOUN	райдер_NOUN
magazine_NOUN	журнал_NOUN
destruction_NOUN	уничтожение_NOUN
deploy_VERB	развертывать_VERB
isolate_VERB	изолировать_VERB
originally_ADV	первоначально_ADV
area_NOUN	площадь_NOUN
austin_NOUN	остин_NOUN
layout_NOUN	макет_NOUN
decline_VERB	отклонить_VERB
resolve_VERB	разрешать_VERB
size_NOUN	размер_NOUN
education_NOUN	просвещение_NOUN
example_NOUN	пример_NOUN
notice_VERB	замечать_VERB
cap_NOUN	кап_NOUN
giant_NOUN	гигант_NOUN
design_NOUN	дизайн_NOUN
middle_ADJ	средний_ADJ
performance_NOUN	производительность_NOUN
jurisdiction_NOUN	юрисдикция_NOUN
sleep_NOUN	сон_NOUN
editor_NOUN	редактор_NOUN
taiwant_NOUN	тайвань_NOUN
mouse_NOUN	мышь_NOUN
minimum_NOUN	минимум_NOUN
fork_NOUN	вилка_NOUN
appearing_VERB	появляться_VERB
county_NOUN	графство_NOUN
strategy_NOUN	стратегия_NOUN
sand_NOUN	песок_NOUN
session_NOUN	сессия_NOUN
training_NOUN	тренинг_NOUN
nonsense_NOUN	чепуха_NOUN
suburb_NOUN	пригород_NOUN
baby_NOUN	ребенок_NOUN
sale_NOUN	продажа_NOUN
time_NOUN	время_NOUN
issue_VERB	выдавать_VERB
easier_ADJ	просто_ADJ
blake_NOUN	блейк_NOUN
offer_NOUN	предложение_NOUN
silver_NOUN	серебро_NOUN
finishing_NOUN	завершение_NOUN
mechanism_NOUN	механизм_NOUN
involvement_NOUN	вовлечение_NOUN
sound_VERB	звучать_VERB
resort_NOUN	курорт_NOUN
impact_NOUN	последствие_NOUN
transfer_NOUN	передача_NOUN
coffee_NOUN	кофе_NOUN
package_NOUN	посылка_NOUN
passage_NOUN	проход_NOUN
get_VERB	получать_VERB
love_NOUN	любовь_NOUN
show_VERB	показывать_VERB
flood_NOUN	наводнение_NOUN
expand_VERB	расширяться_VERB
sit_VERB	село_VERB
ready_ADJ	готовый_ADJ
profession_NOUN	профессия_NOUN
frequency_NOUN	частота_NOUN
poor_ADJ	бедный_ADJ
acquire_VERB	приобретать_VERB
attack_NOUN	атака_NOUN
temporary_ADJ	временный_ADJ
framework_NOUN	рамка_NOUN
sample_NOUN	проба_NOUN
value_NOUN	стоимость_NOUN
air_NOUN	воздух_NOUN
severe_ADJ	суровый_ADJ
technology_NOUN	технология_NOUN
leave_VERB	оставить_VERB
minute_NOUN	минута_NOUN
moment_NOUN	момент_NOUN
historical_ADJ	исторический_ADJ
collection_NOUN	коллекция_NOUN
smart_ADJ	умный_ADJ
soon_ADV	скоро_ADV
portrait_NOUN	портрет_NOUN
disagree_NOUN	несогласие_NOUN
graduation_NOUN	выпускной_NOUN
graphic_ADJ	графический_ADJ
paint_VERB	рисовать_VERB
distance_NOUN	расстояние_NOUN
literacy_NOUN	грамотность_NOUN
reduction_NOUN	уменьшение_NOUN
medicine_NOUN	медицина_NOUN
general_ADJ	общий_ADJ
enterprise_NOUN	предпринимательство_NOUN
president_NOUN	президент_NOUN
television_NOUN	телевизор_NOUN
battery_NOUN	батарея_NOUN
fundamental_ADJ	фундаментальный_ADJ
go_VERB	идти_VERB
weekend_NOUN	уик-энд_NOUN
mystery_NOUN	загадка_NOUN
bed_NOUN	постель_NOUN
charter_NOUN	хартия_NOUN
guide_NOUN	руководство_NOUN
upper_ADJ	верхний_ADJ
wind_NOUN	ветер_NOUN
extremely_ADV	чрезвычайно_ADV
natural_ADJ	природный_ADJ
malaysia_NOUN	малайзия_NOUN
murder_VERB	убитый_VERB
briefly_ADV	кратко_ADV
small_ADJ	маленький_ADJ
encyclopedia_NOUN	энциклопедия_NOUN
vanity_NOUN	суета_NOUN
italian_ADJ	итальянский_ADJ
revision_NOUN	пересмотр_NOUN
formation_NOUN	формирование_NOUN
speed_NOUN	скорость_NOUN
rule_NOUN	правило_NOUN
happen_VERB	случаться_VERB
reaction_NOUN	реакция_NOUN
port_NOUN	порт_NOUN
birmingham_NOUN	бирминге_NOUN
stat_NOUN	статистика_NOUN
surgery_NOUN	операция_NOUN
gate_NOUN	врата_NOUN
gift_NOUN	подарок_NOUN
figure_NOUN	цифра_NOUN
involvement_NOUN	участие_NOUN
organic_ADJ	органический_ADJ
terrorism_NOUN	терроризм_NOUN
action_NOUN	действие_NOUN
theoretical_ADJ	теоретический_ADJ
write_VERB	написать_VERB
regulation_NOUN	регламент_NOUN
region_NOUN	регион_NOUN
anne_NOUN	энна_NOUN
ban_VERB	запрещать_VERB
which_PRON	который_PRON
essay_NOUN	сочинение_NOUN
coloney_NOUN	колония_NOUN
decline_VERB	отклонять_VERB
local_ADJ	местный_ADJ
major_ADJ	основной_ADJ
spot_NOUN	место_NOUN
production_NOUN	производство_NOUN
disc_NOUN	диск_NOUN
magic_NOUN	волшебство_NOUN
domain_NOUN	домен_NOUN
security_NOUN	охрана_NOUN
implement_VERB	осуществить_VERB
heat_NOUN	жара_NOUN
jason_NOUN	джейсона_NOUN
find_VERB	находить_VERB
insurance_NOUN	страховка_NOUN
hair_NOUN	волос_NOUN
colour_NOUN	цвет_NOUN
style_NOUN	стиль_NOUN
attitude_NOUN	позиция_NOUN
capital_NOUN	капитал_NOUN
counter_NOUN	счетчик_NOUN
aaron_NOUN	аарон_NOUN
commune_NOUN	община_NOUN
identification_NOUN	выявление_NOUN
london_NOUN	лондон_NOUN
celebration_NOUN	торжество_NOUN
rich_ADJ	богатый_ADJ
share_NOUN	акция_NOUN
six_NUM	шесть_NUM
impossible_ADJ	невозможный_ADJ
somewhat_ADV	отчасти_ADV
response_NOUN	реакция_NOUN
continental_ADJ	континентальный_ADJ
diameter_NOUN	диаметр_NOUN
fight_NOUN	бой_NOUN
argentina_NOUN	аргентина_NOUN
creation_NOUN	создание_NOUN
relation_NOUN	отношение_NOUN
significance_NOUN	значимость_NOUN
sheffield_NOUN	шеффилд_NOUN
definitely_ADV	определенно_ADV
proper_ADJ	надлежать_ADJ
variant_NOUN	вариант_NOUN
blue_ADJ	синий_ADJ
nature_NOUN	натура_NOUN
pretty_ADV	довольно_ADV
pete_NOUN	пит_NOUN
title_NOUN	титул_NOUN
score_NOUN	балл_NOUN
significantly_ADV	существенно_ADV
invite_VERB	пригласить_VERB
poll_NOUN	опрос_NOUN
depth_NOUN	глубина_NOUN
sum_NOUN	сумма_NOUN
corresponding_NOUN	соответствующий_NOUN
meet_VERB	встречаться_VERB
communist_ADJ	коммунистический_ADJ
arrange_VERB	организовывать_VERB
research_NOUN	исследование_NOUN
mark_NOUN	марка_NOUN
route_NOUN	трасса_NOUN
home_ADV	дома_ADV
byte_NOUN	байть_NOUN
soil_NOUN	почва_NOUN
stream_NOUN	ручей_NOUN
forever_ADV	навсегда_ADV
anchor_NOUN	якорь_NOUN
valley_NOUN	долина_NOUN
storage_NOUN	хранилище_NOUN
too_ADV	слишком_ADV
fly_VERB	летать_VERB
sailing_NOUN	плавание_NOUN
active_ADJ	активный_ADJ
troops_NOUN	войска_NOUN
preservation_NOUN	сохранение_NOUN
career_NOUN	карьера_NOUN
horse_NOUN	лошадка_NOUN
feel_NOUN	ощущение_NOUN
industry_NOUN	отрасль_NOUN
vandalism_NOUN	вандализм_NOUN
altitude_NOUN	высота_NOUN
neighborhood_NOUN	район_NOUN
survive_VERB	выживать_VERB
part_NOUN	запчасть_NOUN
fellow_NOUN	стипендиат_NOUN
serve_VERB	служить_VERB
select_VERB	выбирать_VERB
one_NUM	один_NUM
decide_VERB	решать_VERB
gulf_NOUN	залив_NOUN
wayne_NOUN	уэйн_NOUN
cooper_NOUN	купирать_NOUN
poverty_NOUN	нищета_NOUN
watson_NOUN	ватсон_NOUN
christ_NOUN	христос_NOUN
seat_NOUN	сиденье_NOUN
jose_NOUN	жозе_NOUN
table_NOUN	стол_NOUN
treat_VERB	лечить_VERB
lion_NOUN	лев_NOUN
director_NOUN	режиссер_NOUN
rise_NOUN	подъем_NOUN
list_NOUN	список_NOUN
very_ADV	очень_ADV
analysis_NOUN	анализ_NOUN
hardly_ADV	едва_ADV
loan_NOUN	заем_NOUN
continuous_ADJ	непрерывный_ADJ
interactive_ADJ	интерактивный_ADJ
guy_NOUN	пацан_NOUN
process_NOUN	процесс_NOUN
fire_VERB	увольнять_VERB
shadow_NOUN	тень_NOUN
athletic_ADJ	спортивный_ADJ
test_NOUN	проверка_NOUN
term_NOUN	термин_NOUN
want_VERB	хотеть_VERB
permit_VERB	разрешать_VERB
poster_NOUN	постер_NOUN
content_NOUN	содержимое_NOUN
summary_NOUN	сводка_NOUN
travel_VERB	путешествовать_VERB
patrol_NOUN	патруль_NOUN
harrison_NOUN	гаррисон_NOUN
fail_NOUN	провал_NOUN
monster_NOUN	монстр_NOUN
invasion_NOUN	вторжение_NOUN
wife_NOUN	жена_NOUN
mary_NOUN	мерь_NOUN
track_NOUN	след_NOUN
famous_ADJ	знаменитый_ADJ
publication_NOUN	опубликование_NOUN
zone_NOUN	зона_NOUN
subject_NOUN	объект_NOUN
alexander_NOUN	александирать_NOUN
police_NOUN	полиция_NOUN
religious_ADJ	религиозный_ADJ
expand_VERB	расширить_VERB
storm_NOUN	буря_NOUN
contain_VERB	содержать_VERB
revenue_NOUN	доход_NOUN
chan_NOUN	чан_NOUN
design_NOUN	конструкция_NOUN
gene_NOUN	джин_NOUN
nobody_PRON	никто_PRON
machine_NOUN	машина_NOUN
legislation_NOUN	законодательство_NOUN
cycle_NOUN	цикл_NOUN
democrat_NOUN	демократ_NOUN
wikimedia_NOUN	викимедиа_NOUN
sang_VERB	петь_VERB
copenhagen_NOUN	копенгаген_NOUN
immigration_NOUN	иммиграция_NOUN
closer_ADJ	близкий_ADJ
george_NOUN	георгия_NOUN
ability_NOUN	умение_NOUN
small_ADJ	мелкий_ADJ
follow_VERB	подписываться_VERB
fall_NOUN	падать_NOUN
control_NOUN	контроль_NOUN
castle_NOUN	замок_NOUN
lieutenant_NOUN	лейтенант_NOUN
fight_VERB	сражаться_VERB
holiday_NOUN	праздник_NOUN
apr_NOUN	апр._NOUN
fate_NOUN	судьба_NOUN
subsequently_ADV	впоследствии_ADV
variation_NOUN	вариация_NOUN
philosopher_NOUN	философ_NOUN
arrest_VERB	задерживать_VERB
worship_NOUN	поклонение_NOUN
contribution_NOUN	вклад_NOUN
smith_NOUN	смит_NOUN
wealthy_ADJ	богатый_ADJ
back_ADV	обратно_ADV
hardware_NOUN	оборудование_NOUN
vladimir_NOUN	владимир_NOUN
answer_NOUN	ответ_NOUN
le_NOUN	лезть_NOUN
harbor_NOUN	гавань_NOUN
daniel_NOUN	дэниэл_NOUN
elder_NOUN	старший_NOUN
supporter_NOUN	сторонник_NOUN
fox_NOUN	фокс_NOUN
deny_VERB	отрицать_VERB
jordan_NOUN	джорданин_NOUN
coin_NOUN	монета_NOUN
grounds_NOUN	основание_NOUN
under_ADP	под_ADP
iranian_ADJ	иранский_ADJ
trouble_NOUN	неприятность_NOUN
islamic_ADJ	исламский_ADJ
comment_VERB	комментировать_VERB
col_NOUN	кол_NOUN
range_NOUN	дальность_NOUN
conclusion_NOUN	вывод_NOUN
feedback_NOUN	отклик_NOUN
dancing_NOUN	танец_NOUN
ticket_NOUN	билет_NOUN
negative_ADJ	отрицательный_ADJ
twelve_NUM	двенадцать_NUM
democracy_NOUN	демократия_NOUN
guard_NOUN	страж_NOUN
official_NOUN	чиновник_NOUN
recent_ADJ	последний_ADJ
purchase_NOUN	закупка_NOUN
damage_VERB	повредить_VERB
contract_NOUN	контракт_NOUN
solve_VERB	решать_VERB
talent_NOUN	талант_NOUN
mountain_NOUN	гора_NOUN
funeral_NOUN	похороны_NOUN
cuban_ADJ	кубинский_ADJ
cotton_NOUN	хлопок_NOUN
chairman_NOUN	председатель_NOUN
westminster_NOUN	вестминстер_NOUN
drug_NOUN	препарат_NOUN
dog_NOUN	собака_NOUN
location_NOUN	местоположение_NOUN
agency_NOUN	агенство_NOUN
victor_NOUN	виктор_NOUN
expert_NOUN	эксперт_NOUN
density_NOUN	плотность_NOUN
electricity_NOUN	электричество_NOUN
maximum_ADJ	максимальный_ADJ
drawn_VERB	обращать_VERB
lower_ADJ	нижний_ADJ
examination_NOUN	экзамен_NOUN
bright_ADJ	светлый_ADJ
song_NOUN	песнь_NOUN
orientation_NOUN	ориентация_NOUN
bill_NOUN	законопроект_NOUN
breeding_NOUN	разведение_NOUN
costa_NOUN	кост_NOUN
broadcast_NOUN	вещание_NOUN
feel_NOUN	чувство_NOUN
burn_VERB	сгорать_VERB
pressure_NOUN	давление_NOUN
empty_ADJ	пустой_ADJ
injure_VERB	ранить_VERB
future_NOUN	будущее_NOUN
master_NOUN	хозяин_NOUN
samuel_NOUN	сэмюэль_NOUN
dan_NOUN	дэн_NOUN
campus_NOUN	кампус_NOUN
switch_NOUN	переключение_NOUN
institution_NOUN	институт_NOUN
ongoing_ADJ	текущий_ADJ
tie_VERB	привязывать_VERB
measure_VERB	измерять_VERB
workshop_NOUN	мастерская_NOUN
acceptable_ADJ	допустимый_ADJ
conclusion_NOUN	заключение_NOUN
usage_NOUN	использование_NOUN
news_NOUN	новость_NOUN
commentary_NOUN	комментарий_NOUN
appreciate_VERB	оценивать_VERB
fernando_NOUN	фернандо_NOUN
davie_NOUN	дэвис_NOUN
trade_NOUN	торговля_NOUN
application_NOUN	заявка_NOUN
ton_NOUN	тонна_NOUN
voivodeship_NOUN	воеводство_NOUN
alexander_NOUN	александр_NOUN
description_NOUN	описание_NOUN
best_ADJ	лучший_ADJ
compet_VERB	соревноваться_VERB
personality_NOUN	личность_NOUN
jump_VERB	прыгать_VERB
ukrainian_ADJ	украинский_ADJ
bowl_NOUN	чаша_NOUN
orange_ADJ	оранжевый_ADJ
restore_VERB	восстановить_VERB
mill_NOUN	миллс_NOUN
syria_NOUN	сирий_NOUN
copper_NOUN	медь_NOUN
filming_NOUN	съемка_NOUN
book_NOUN	книга_NOUN
personality_NOUN	индивидуальность_NOUN
friendly_ADJ	дружественный_ADJ
revenue_NOUN	поступление_NOUN
valuable_ADJ	ценный_ADJ
voyage_NOUN	путешествие_NOUN
sector_NOUN	сектор_NOUN
norfolk_NOUN	норфолк_NOUN
recognize_VERB	распознавать_VERB
turn_VERB	повернуть_VERB
nice_ADJ	приятный_ADJ
cornwall_NOUN	корнуоллар_NOUN
adelaide_NOUN	аделаида_NOUN
york_NOUN	йорк_NOUN
santa_NOUN	сант_NOUN
christianity_NOUN	христианство_NOUN
designer_NOUN	дизайнер_NOUN
queens_NOUN	королева_NOUN
send_VERB	посылать_VERB
introduce_VERB	вводить_VERB
michael_NOUN	майкл_NOUN
transfer_VERB	переводить_VERB
helpful_ADJ	полезный_ADJ
wild_ADJ	дикий_ADJ
solar_ADJ	солнечный_ADJ
recent_ADJ	недавний_ADJ
line_NOUN	строка_NOUN
existence_NOUN	существование_NOUN
vessel_NOUN	судно_NOUN
stable_ADJ	стабильный_ADJ
rename_VERB	переименовать_VERB
emperor_NOUN	император_NOUN
oscar_NOUN	оскар_NOUN
design_VERB	разрабатывать_VERB
bodie_NOUN	тело_NOUN
lanka_NOUN	ланка_NOUN
jame_NOUN	джеймс_NOUN
colin_NOUN	колено_NOUN
mary_NOUN	мэри_NOUN
johnson_NOUN	джонсон_NOUN
merge_NOUN	объединение_NOUN
ministry_NOUN	министерство_NOUN
intervention_NOUN	интервенция_NOUN
supply_VERB	поставлять_VERB
six_NUM	шестеро_NUM
drop_NOUN	капля_NOUN
present_NOUN	подарок_NOUN
pride_NOUN	гордыня_NOUN
track_NOUN	трек_NOUN
favorite_ADJ	любимый_ADJ
few_ADJ	немногие_ADJ
mechanical_ADJ	механический_ADJ
standard_NOUN	норма_NOUN
requirement_NOUN	потребность_NOUN
generate_VERB	генерировать_VERB
fresh_ADJ	свежо_ADJ
burn_NOUN	ожог_NOUN
box_NOUN	ящик_NOUN
aim_NOUN	цель_NOUN
familiar_ADJ	знакомый_ADJ
student_NOUN	студент_NOUN
finish_VERB	завершать_VERB
cat_NOUN	кошка_NOUN
register_VERB	зарегистрироваться_VERB
purpose_NOUN	цель_NOUN
judge_NOUN	судья_NOUN
collection_NOUN	подборка_NOUN
character_NOUN	символ_NOUN
engine_NOUN	мотор_NOUN
hear_VERB	слышать_VERB
ahead_ADV	впереди_ADV
raid_NOUN	налет_NOUN
biography_NOUN	биография_NOUN
difference_NOUN	различие_NOUN
meeting_NOUN	встреча_NOUN
product_NOUN	произведение_NOUN
revival_NOUN	возрождение_NOUN
anniversary_NOUN	годовщина_NOUN
bio_NOUN	биографический_NOUN
significantly_ADV	значительно_ADV
foundation_NOUN	фундамент_NOUN
concept_NOUN	концепция_NOUN
scholarship_NOUN	стипендия_NOUN
raymond_NOUN	реймонд_NOUN
update_NOUN	обновление_NOUN
unnecessary_ADJ	ненужный_ADJ
spouse_NOUN	супруг_NOUN
hope_VERB	надеяться_VERB
village_NOUN	село_NOUN
hill_NOUN	хиллз_NOUN
van_NOUN	фургон_NOUN
position_NOUN	положение_NOUN
try_VERB	пробовать_VERB
archaeological_ADJ	археологический_ADJ
education_NOUN	образование_NOUN
mouth_NOUN	рот_NOUN
announce_VERB	объявлять_VERB
level_NOUN	уровень_NOUN
laura_NOUN	лаур_NOUN
with_ADP	с_ADP
municipality_NOUN	муниципалитет_NOUN
happy_ADJ	счастливый_ADJ
amendment_NOUN	поправка_NOUN
patent_NOUN	патент_NOUN
arrest_NOUN	арест_NOUN
farm_NOUN	ферма_NOUN
baker_NOUN	бейкер_NOUN
escape_NOUN	побег_NOUN
rate_NOUN	ставка_NOUN
designate_VERB	назначать_VERB
spider_NOUN	паук_NOUN
sixth_NOUN	шестой_NOUN
jan_NOUN	ян_NOUN
carry_VERB	нести_VERB
band_NOUN	полоса_NOUN
life_NOUN	жизнь_NOUN
oral_ADJ	устный_ADJ
final_ADJ	заключительный_ADJ
damage_NOUN	вред_NOUN
income_NOUN	поступление_NOUN
share_NOUN	доля_NOUN
select_VERB	выделять_VERB
shot_NOUN	кадр_NOUN
commander_NOUN	командор_NOUN
gilbert_NOUN	гилберт_NOUN
immediate_ADJ	немедленный_ADJ
notify_VERB	уведомлять_VERB
eastern_ADJ	восточный_ADJ
universe_NOUN	вселенная_NOUN
sentences_NOUN	приговор_NOUN
con_NOUN	кон_NOUN
evening_NOUN	вечерний_NOUN
recommend_VERB	рекомендовать_VERB
ralph_NOUN	ральф_NOUN
opinion_NOUN	мнение_NOUN
inhabitant_NOUN	житель_NOUN
start_VERB	начинать_VERB
puerto_NOUN	пуэрто_NOUN
stop_VERB	останавливать_VERB
presidency_NOUN	президиум_NOUN
until_ADP	до_ADP
movement_NOUN	передвижение_NOUN
brother_NOUN	братец_NOUN
learn_VERB	узнавать_VERB
regulation_NOUN	правило_NOUN
license_NOUN	лицензия_NOUN
cut_VERB	сокращать_VERB
encourage_VERB	поощрять_VERB
outdoor_ADJ	открывать_ADJ
radiation_NOUN	радиация_NOUN
distinctive_ADJ	отличительный_ADJ
violence_NOUN	насилие_NOUN
failure_NOUN	провал_NOUN
bear_NOUN	медведь_NOUN
range_NOUN	диапазон_NOUN
phil_NOUN	фила_NOUN
species_NOUN	вид_NOUN
soldier_NOUN	солдат_NOUN
navigation_NOUN	навигация_NOUN
weather_NOUN	погода_NOUN
beat_NOUN	избиение_NOUN
radiation_NOUN	излучение_NOUN
bill_NOUN	счет_NOUN
paragraph_NOUN	параграф_NOUN
rule_VERB	постановлять_VERB
advance_NOUN	аванс_NOUN
cover_NOUN	прикрытие_NOUN
closing_NOUN	закрытие_NOUN
angel_NOUN	анхель_NOUN
funding_NOUN	финансирование_NOUN
look_VERB	смотреть_VERB
invent_VERB	изобретать_VERB
tagg_VERB	отмечать_VERB
oxygen_NOUN	кислород_NOUN
song_NOUN	песня_NOUN
kenya_NOUN	кение_NOUN
often_ADV	зачастую_ADV
value_NOUN	значение_NOUN
rabbi_NOUN	раввин_NOUN
injury_NOUN	вред_NOUN
dame_NOUN	дама_NOUN
composer_NOUN	композитор_NOUN
founder_NOUN	основатель_NOUN
quarter_NOUN	четверть_NOUN
municipal_ADJ	муниципальный_ADJ
concern_NOUN	беспокойство_NOUN
accompany_VERB	сопровождать_VERB
squad_NOUN	спасатель_NOUN
impact_NOUN	воздействие_NOUN
implementation_NOUN	реализация_NOUN
recovery_NOUN	оздоровление_NOUN
samuel_NOUN	сэмюэл_NOUN
return_NOUN	возврат_NOUN
airport_NOUN	аэропорт_NOUN
month_NOUN	месяц_NOUN
wire_NOUN	провод_NOUN
crime_NOUN	преступность_NOUN
occupation_NOUN	оккупация_NOUN
male_NOUN	самец_NOUN
flash_NOUN	флеш_NOUN
affiliate_VERB	связывать_VERB
radar_NOUN	радар_NOUN
match_NOUN	матч_NOUN
stone_NOUN	стоун_NOUN
baby_NOUN	малышка_NOUN
assault_NOUN	нападение_NOUN
efficiency_NOUN	эффективность_NOUN
butler_NOUN	батлер_NOUN
statistic_NOUN	статистика_NOUN
growth_NOUN	рост_NOUN
artist_NOUN	артист_NOUN
procedure_NOUN	процедура_NOUN
note_NOUN	нота_NOUN
investment_NOUN	инвестирование_NOUN
diplomatic_ADJ	дипломатический_ADJ
fish_NOUN	рыбка_NOUN
papers_NOUN	бумага_NOUN
montana_NOUN	монтан_NOUN
existence_NOUN	бытие_NOUN
five_NUM	пять_NUM
final_ADJ	окончательный_ADJ
observation_NOUN	наблюдение_NOUN
internal_ADJ	внутренний_ADJ
fishing_NOUN	рыбалка_NOUN
next_ADV	далее_ADV
enough_ADV	достаточно_ADV
honor_NOUN	честь_NOUN
against_ADP	против_ADP
good_ADJ	хороший_ADJ
journal_NOUN	дневник_NOUN
piano_NOUN	рояль_NOUN
break_VERB	сломать_VERB
saint_VERB	святой_VERB
structural_ADJ	структурный_ADJ
footballer_NOUN	футболист_NOUN
singer_NOUN	певец_NOUN
voting_NOUN	голосование_NOUN
iron_ADJ	железный_ADJ
remove_VERB	убирать_VERB
doc_NOUN	док_NOUN
describe_VERB	описывать_VERB
disambiguation_NOUN	значение_NOUN
donate_VERB	пожертвовать_VERB
circuit_NOUN	цепь_NOUN
economics_NOUN	экономика_NOUN
prize_NOUN	приз_NOUN
fashion_NOUN	мода_NOUN
visible_ADJ	видимый_ADJ
break_VERB	ломать_VERB
denmark_NOUN	дание_NOUN
evolve_VERB	эволюционировать_VERB
fight_NOUN	драка_NOUN
eat_VERB	он_VERB
bonus_NOUN	бонус_NOUN
inning_NOUN	иннинг_NOUN
lord_NOUN	господь_NOUN
staff_NOUN	персонал_NOUN
introduction_NOUN	введение_NOUN
warring_VERB	воють_VERB
restriction_NOUN	ограничение_NOUN
presidency_NOUN	председательство_NOUN
disaster_NOUN	катастрофа_NOUN
daily_ADV	ежедневно_ADV
corner_NOUN	уголок_NOUN
census_NOUN	перепись_NOUN
islamic_ADJ	исламское_ADJ
product_NOUN	изделие_NOUN
freely_ADV	свободно_ADV
lock_NOUN	блокировка_NOUN
move_VERB	двигаться_VERB
desert_NOUN	пустыня_NOUN
tue_NOUN	вть_NOUN
remain_VERB	оставаться_VERB
harbor_NOUN	харбор_NOUN
intent_NOUN	намерение_NOUN
authority_NOUN	полномочие_NOUN
soccer_NOUN	футбол_NOUN
length_NOUN	длина_NOUN
fix_VERB	исправлять_VERB
legend_NOUN	легенда_NOUN
large_ADJ	большой_ADJ
fast_ADJ	быстрый_ADJ
succeed_VERB	удаваться_VERB
competition_NOUN	конкуренция_NOUN
relationship_NOUN	отношение_NOUN
controversy_NOUN	спор_NOUN
initially_ADV	первоначально_ADV
academics_NOUN	ученый_NOUN
talk_VERB	говорить_VERB
popular_ADJ	популярный_ADJ
defense_NOUN	оборона_NOUN
francis_NOUN	франсис_NOUN
frank_NOUN	фрэнк_NOUN
rock_NOUN	камень_NOUN
falling_NOUN	падение_NOUN
extreme_ADJ	крайний_ADJ
plane_NOUN	плоскость_NOUN
physical_ADJ	физический_ADJ
abandon_VERB	оставить_VERB
chancellor_NOUN	ректор_NOUN
canton_NOUN	кантон_NOUN
difference_NOUN	разница_NOUN
test_NOUN	испытание_NOUN
greatest_ADJ	величайший_ADJ
engage_VERB	помолвлять_VERB
turn_VERB	переходить_VERB
keep_VERB	держать_VERB
moon_NOUN	мун_NOUN
secure_VERB	обеспечивать_VERB
professional_ADJ	профессиональный_ADJ
personal_ADJ	личной_ADJ
opera_NOUN	опера_NOUN
leader_NOUN	руководитель_NOUN
administrative_ADJ	административный_ADJ
wheel_NOUN	колесо_NOUN
continuous_ADJ	постоянный_ADJ
allow_VERB	допускать_VERB
parish_NOUN	волость_NOUN
settle_VERB	урегулировать_VERB
cycling_NOUN	велоспорт_NOUN
who_PRON	кто_PRON
century_NOUN	столетие_NOUN
ultimate_ADJ	конечный_ADJ
danny_NOUN	деннь_NOUN
back_ADV	назад_ADV
execution_NOUN	исполнение_NOUN
noble_ADJ	благородный_ADJ
musical_ADJ	музыкальный_ADJ
artificial_ADJ	искусственный_ADJ
change_VERB	изменять_VERB
suppose_VERB	предполагать_VERB
owner_NOUN	владелец_NOUN
clerk_NOUN	клерк_NOUN
rugby_NOUN	регби_NOUN
intention_NOUN	намерение_NOUN
user_NOUN	пользователь_NOUN
dyk_NOUN	даек_NOUN
barry_NOUN	бэрри_NOUN
star_NOUN	звезда_NOUN
include_VERB	включать_VERB
map_NOUN	карта_NOUN
indeed_ADV	воистину_ADV
display_VERB	отображаться_VERB
resolution_NOUN	разрешение_NOUN
agree_VERB	соглашаться_VERB
sky_NOUN	небо_NOUN
discovery_NOUN	обнаружение_NOUN
either_CCONJ	либо_CCONJ
frequency_NOUN	периодичность_NOUN
perhaps_ADV	возможный_ADV
digital_ADJ	цифровой_ADJ
evolution_NOUN	эволюция_NOUN
creation_NOUN	сотворение_NOUN
partial_ADJ	частичный_ADJ
emigrant_NOUN	эмигрант_NOUN
rookie_NOUN	новичок_NOUN
broadcast_NOUN	трансляция_NOUN
result_NOUN	результат_NOUN
tennis_NOUN	теннис_NOUN
reform_NOUN	реформа_NOUN
dance_NOUN	танец_NOUN
firm_NOUN	фирма_NOUN
finance_NOUN	финансирование_NOUN
virgin_NOUN	девственница_NOUN
beam_NOUN	луч_NOUN
repeate_VERB	повторяться_VERB
attitude_NOUN	настрой_NOUN
celebration_NOUN	праздник_NOUN
visit_NOUN	визит_NOUN
collaboration_NOUN	сотрудничество_NOUN
centuries_NOUN	столетие_NOUN
communication_NOUN	общение_NOUN
passenger_NOUN	пассажир_NOUN
identify_VERB	идентифицировать_VERB
honour_NOUN	честь_NOUN
currency_NOUN	валюта_NOUN
clock_NOUN	час_NOUN
punjab_NOUN	пенджаба_NOUN
heart_NOUN	сердце_NOUN
resident_NOUN	резидент_NOUN
story_NOUN	новость_NOUN
mode_NOUN	режим_NOUN
clean_ADJ	чистый_ADJ
proof_NOUN	доказательство_NOUN
aire_NOUN	айрес_NOUN
russian_ADJ	российский_ADJ
degree_NOUN	градус_NOUN
drink_VERB	пить_VERB
understanding_NOUN	понимание_NOUN
fan_NOUN	вентилятор_NOUN
post_NOUN	публикация_NOUN
bad_ADJ	плохой_ADJ
sex_NOUN	секс_NOUN
upload_NOUN	загрузка_NOUN
conversion_NOUN	преобразование_NOUN
route_NOUN	маршрут_NOUN
anthony_NOUN	антоний_NOUN
la_NOUN	лас_NOUN
do_VERB	делать_VERB
star_VERB	снимать_VERB
plan_NOUN	план_NOUN
northern_ADJ	северный_ADJ
enterprise_NOUN	энтерпрайз_NOUN
rock_NOUN	скала_NOUN
gospel_NOUN	евангелие_NOUN
leader_NOUN	лидер_NOUN
hudson_NOUN	хадсона_NOUN
complete_VERB	завершить_VERB
don_NOUN	дон_NOUN
computer_NOUN	компьютер_NOUN
take_VERB	принимать_VERB
mind_NOUN	разум_NOUN
mother_NOUN	мать_NOUN
usage_NOUN	употребление_NOUN
card_NOUN	карточка_NOUN
joseph_NOUN	жозеф_NOUN
citizen_NOUN	гражданин_NOUN
advertising_NOUN	реклама_NOUN
strength_NOUN	прочность_NOUN
victim_NOUN	жертва_NOUN
launch_VERB	запускать_VERB
loss_NOUN	утрата_NOUN
recommend_VERB	рекомендуемай_VERB
climate_NOUN	климат_NOUN
constant_ADJ	постоянная_ADJ
arrive_VERB	приезжать_VERB
testing_NOUN	проверка_NOUN
dancer_NOUN	танцор_NOUN
kingdom_NOUN	королевство_NOUN
direct_VERB	направлять_VERB
chan_NOUN	тянин_NOUN
bass_NOUN	бас_NOUN
easily_ADV	легкий_ADV
sword_NOUN	меч_NOUN
specialize_VERB	специализированный_VERB
full_ADJ	полный_ADJ
damage_NOUN	ущерб_NOUN
miller_NOUN	миллер_NOUN
districts_NOUN	район_NOUN
method_NOUN	метод_NOUN
simon_NOUN	саймон_NOUN
cup_NOUN	чашка_NOUN
turkey_NOUN	турция_NOUN
defence_NOUN	оборона_NOUN
york_NOUN	йорка_NOUN
symphony_NOUN	симфония_NOUN
initiate_VERB	начинать_VERB
palm_NOUN	ладонь_NOUN
pupil_NOUN	учащийся_NOUN
incorrect_ADJ	неправильный_ADJ
position_NOUN	позиция_NOUN
boy_NOUN	мальчишка_NOUN
key_NOUN	клавиша_NOUN
stadium_NOUN	стадион_NOUN
additionally_ADV	дополнительно_ADV
type_NOUN	вид_NOUN
panama_NOUN	панама_NOUN
finishing_NOUN	отделка_NOUN
stage_NOUN	стадия_NOUN
lloyd_NOUN	ллойд_NOUN
journalist_NOUN	журналист_NOUN
tribe_NOUN	племя_NOUN
account_NOUN	счет_NOUN
defeat_NOUN	поражение_NOUN
behaviour_NOUN	поведение_NOUN
repeatedly_ADV	многократно_ADV
bueno_NOUN	буэнос_NOUN
suffer_VERB	страдать_VERB
georgian_ADJ	грузинский_ADJ
appearance_NOUN	внешность_NOUN
conductor_NOUN	проводник_NOUN
activity_NOUN	деятельность_NOUN
earn_VERB	зарабатывать_VERB
orego_NOUN	орегон_NOUN
suspend_VERB	приостанавливать_VERB
linear_NOUN	линейный_NOUN
manager_NOUN	управляющий_NOUN
sign_VERB	подписать_VERB
corruption_NOUN	коррупция_NOUN
local_ADJ	локальный_ADJ
be_AUX	быть_AUX
form_NOUN	форма_NOUN
fish_NOUN	рыба_NOUN
survey_NOUN	обследование_NOUN
claim_VERB	утверждать_VERB
guy_NOUN	парень_NOUN
customer_NOUN	посетитель_NOUN
then_ADV	тогда_ADV
draw_VERB	привлекать_VERB
factory_NOUN	завод_NOUN
horn_NOUN	хорн_NOUN
lake_NOUN	лейк_NOUN
plate_NOUN	тарелка_NOUN
amount_NOUN	сумма_NOUN
swiss_NOUN	швейцарский_NOUN
offex_NOUN	отделение_NOUN
mother_NOUN	мама_NOUN
renown_ADJ	известный_ADJ
contrast_NOUN	контраст_NOUN
fuel_NOUN	горючее_NOUN
cook_VERB	готовить_VERB
find_VERB	найти_VERB
crash_NOUN	авария_NOUN
walker_NOUN	уокер_NOUN
dispute_NOUN	спор_NOUN
flower_NOUN	цветы_NOUN
study_NOUN	исследование_NOUN
percentage_NOUN	процент_NOUN
tank_NOUN	цистерна_NOUN
visitor_NOUN	гость_NOUN
fan_NOUN	фанат_NOUN
youth_NOUN	молодежь_NOUN
benefit_NOUN	преимущество_NOUN
mirror_NOUN	зеркало_NOUN
denis_NOUN	денис_NOUN
charle_NOUN	чарльз_NOUN
meeting_NOUN	заседание_NOUN
series_NOUN	серия_NOUN
pass_NOUN	пропуск_NOUN
wolf_NOUN	вулф_NOUN
few_ADJ	немногое_ADJ
island_NOUN	остров_NOUN
insurance_NOUN	страхование_NOUN
difficult_ADJ	трудный_ADJ
senate_NOUN	сенат_NOUN
appeal_NOUN	апелляция_NOUN
parade_NOUN	парад_NOUN
election_NOUN	выборы_NOUN
font_NOUN	шрифт_NOUN
struggle_NOUN	борьба_NOUN
closure_NOUN	закрытие_NOUN
regional_ADJ	региональный_ADJ
transfer_VERB	передать_VERB
champion_NOUN	чемпион_NOUN
artist_NOUN	художник_NOUN
coal_NOUN	уголь_NOUN
guess_VERB	угадать_VERB
argentine_NOUN	аргентина_NOUN
terminal_NOUN	терминал_NOUN
acquisition_NOUN	приобретение_NOUN
eye_NOUN	глаз_NOUN
speak_VERB	говорить_VERB
descendant_NOUN	потомство_NOUN
rome_NOUN	рить_NOUN
hook_NOUN	крючок_NOUN
pacific_ADJ	тихоокеанский_ADJ
decline_VERB	отказываться_VERB
sign_NOUN	знак_NOUN
date_NOUN	свидание_NOUN
honour_NOUN	награда_NOUN
head_NOUN	голова_NOUN
rescue_NOUN	спасатель_NOUN
beauty_NOUN	красота_NOUN
brick_NOUN	кирпич_NOUN
conversation_NOUN	переписка_NOUN
big_ADJ	большой_ADJ
real_ADJ	настоящий_ADJ
finance_NOUN	финансы_NOUN
make_VERB	делать_VERB
chief_NOUN	шеф_NOUN
briefly_ADV	коротко_ADV
developer_NOUN	разработчик_NOUN
navy_NOUN	флот_NOUN
residence_NOUN	проживание_NOUN
detroit_NOUN	детройть_NOUN
approve_VERB	утвердить_VERB
appoint_VERB	назначать_VERB
relationship_NOUN	взаимосвязь_NOUN
bomb_NOUN	бомба_NOUN
lock_NOUN	замок_NOUN
innovation_NOUN	нововведение_NOUN
return_VERB	возвращать_VERB
double_ADJ	двойной_ADJ
copy_NOUN	копирование_NOUN
stock_NOUN	наличие_NOUN
strategic_ADJ	стратегический_ADJ
affect_VERB	затрагивать_VERB
keyboard_NOUN	клавиатура_NOUN
war_NOUN	война_NOUN
you_PRON	ты_PRON
figure_NOUN	фигура_NOUN
efficient_ADJ	эффективный_ADJ
luck_NOUN	удача_NOUN
comparison_NOUN	сопоставление_NOUN
bishop_NOUN	епископ_NOUN
catherine_NOUN	кэтрина_NOUN
civil_ADJ	гражданский_ADJ
terrorist_NOUN	террорист_NOUN
assign_VERB	назначать_VERB
branch_NOUN	сектор_NOUN
inspire_VERB	вдохновить_VERB
entitle_VERB	озаглавливать_VERB
popularity_NOUN	популярность_NOUN
lower_ADJ	ниже_ADJ
disk_NOUN	диск_NOUN
engineer_NOUN	инженер_NOUN
industry_NOUN	индустрия_NOUN
montreal_NOUN	монреаль_NOUN
debute_VERB	дебютировать_VERB
false_ADJ	ложный_ADJ
massacre_NOUN	бойня_NOUN
phenomenon_NOUN	феномен_NOUN
natural_ADJ	естественный_ADJ
state_NOUN	государство_NOUN
solution_NOUN	решение_NOUN
dam_NOUN	давать_NOUN
hundred_NOUN	сотня_NOUN
thought_NOUN	мысль_NOUN
attend_VERB	посещать_VERB
hammer_NOUN	молот_NOUN
recognize_VERB	признавать_VERB
compete_VERB	соревноваться_VERB
important_ADJ	важный_ADJ
significant_ADJ	существенный_ADJ
frame_NOUN	кадр_NOUN
wedding_NOUN	свадьба_NOUN
well_NOUN	уэллс_NOUN
product_NOUN	продукт_NOUN
department_NOUN	департамент_NOUN
quick_ADJ	быстрый_ADJ
filter_NOUN	фильтр_NOUN
jennifer_NOUN	дженифера_NOUN
cork_NOUN	пробка_NOUN
live_VERB	проживать_VERB
work_NOUN	работа_NOUN
chase_NOUN	чейз_NOUN
comprehensive_ADJ	всеобъемлющий_ADJ
monthly_ADJ	ежемесячный_ADJ
thirty_NUM	тридцать_NUM
club_NOUN	клуб_NOUN
parking_NOUN	стоянка_NOUN
come_VERB	приходить_VERB
application_NOUN	применение_NOUN
innovation_NOUN	инновация_NOUN
found_VERB	основывать_VERB
rice_NOUN	рис_NOUN
poverty_NOUN	бедность_NOUN
clay_NOUN	клей_NOUN
occupy_VERB	занимать_VERB
immediately_ADV	незамедлительно_ADV
carrier_NOUN	перевозчик_NOUN
meeting_NOUN	собрание_NOUN
inside_ADV	изнутри_ADV
regime_NOUN	режим_NOUN
december_NOUN	декабрь_NOUN
worse_ADJ	плохо_ADJ
rocket_NOUN	ракета_NOUN
plaza_NOUN	площадь_NOUN
organization_NOUN	организация_NOUN
marketing_NOUN	маркетинг_NOUN
mystery_NOUN	тайна_NOUN
wrestling_NOUN	борьба_NOUN
margaret_NOUN	маргаревать_NOUN
population_NOUN	население_NOUN
grass_NOUN	трава_NOUN
japan_NOUN	японий_NOUN
equipment_NOUN	снаряжение_NOUN
timeline_NOUN	срок_NOUN
relationship_NOUN	взаимоотношение_NOUN
montgomery_NOUN	монтгомерь_NOUN
connect_NOUN	подключение_NOUN
josé_NOUN	жозе_NOUN
identity_NOUN	идентификация_NOUN
wave_NOUN	волна_NOUN
hook_NOUN	хук_NOUN
visit_VERB	посещать_VERB
ring_NOUN	ринг_NOUN
comparison_NOUN	сравнение_NOUN
story_NOUN	история_NOUN
tell_VERB	рассказывать_VERB
reason_NOUN	причина_NOUN
mythology_NOUN	мифология_NOUN
steam_NOUN	пара_NOUN
add_VERB	добавить_VERB
choose_VERB	выбрать_VERB
father_NOUN	отец_NOUN
view_VERB	смотреть_VERB
sean_NOUN	шон_NOUN
chancellor_NOUN	канцлер_NOUN
cameron_NOUN	камерон_NOUN
california_NOUN	калифорние_NOUN
stress_NOUN	стресс_NOUN
electronic_NOUN	электроника_NOUN
civic_ADJ	гражданский_ADJ
biology_NOUN	биология_NOUN
ghana_NOUN	ган_NOUN
jackson_NOUN	джексон_NOUN
ellis_NOUN	эллис_NOUN
experiment_NOUN	опыт_NOUN
hand_NOUN	рука_NOUN
rescue_NOUN	спасение_NOUN
attendance_NOUN	участник_NOUN
complex_NOUN	комплекс_NOUN
template_NOUN	шаблон_NOUN
cover_NOUN	обложка_NOUN
maintenance_NOUN	ведение_NOUN
party_NOUN	партия_NOUN
engineer_NOUN	инженерия_NOUN
drum_NOUN	барабан_NOUN
carter_NOUN	картирать_NOUN
turn_VERB	обращаться_VERB
supreme_ADJ	высший_ADJ
peter_NOUN	петер_NOUN
girl_NOUN	девочка_NOUN
certified_ADJ	сертифицированный_ADJ
powerful_ADJ	могущественный_ADJ
allegation_NOUN	обвинение_NOUN
ghana_NOUN	гана_NOUN
arrest_VERB	арестовывать_VERB
abuse_NOUN	надругательство_NOUN
feature_VERB	рекомендовать_VERB
fire_NOUN	огонь_NOUN
step_NOUN	шаг_NOUN
discuss_VERB	обсуждать_VERB
state_NOUN	штат_NOUN
opposition_NOUN	противодействие_NOUN
item_NOUN	пункт_NOUN
invite_VERB	приглашенный_VERB
appear_VERB	появляться_VERB
statement_NOUN	ведомость_NOUN
type_NOUN	тип_NOUN
woman_NOUN	женщина_NOUN
journalist_NOUN	журналистка_NOUN
testing_NOUN	тестирование_NOUN
regularly_ADV	регулярно_ADV
murder_VERB	убивать_VERB
melbourne_NOUN	мельбурне_NOUN
walk_NOUN	прогулка_NOUN
stewart_NOUN	стюарт_NOUN
seat_NOUN	место_NOUN
plot_NOUN	заговор_NOUN
allow_VERB	разрешать_VERB
record_VERB	записывать_VERB
writing_NOUN	написание_NOUN
welfare_NOUN	благосостояние_NOUN
play_VERB	играть_VERB
store_NOUN	магазин_NOUN
khan_NOUN	хан_NOUN
margin_NOUN	разница_NOUN
danish_NOUN	дание_NOUN
postal_ADJ	почтовый_ADJ
cyclist_NOUN	велосипедист_NOUN
large_ADJ	крупный_ADJ
steven_NOUN	стивенс_NOUN
tomb_NOUN	могила_NOUN
guess_VERB	думать_VERB
processe_NOUN	процесс_NOUN
note_NOUN	примечание_NOUN
streak_NOUN	инсульт_NOUN
nonsense_NOUN	ерунда_NOUN
movie_NOUN	кино_NOUN
index_NOUN	индекс_NOUN
adam_NOUN	адама_NOUN
corporation_NOUN	корпорация_NOUN
ethnic_ADJ	этнический_ADJ
bat_NOUN	бита_NOUN
comics_NOUN	комикс_NOUN
terminus_NOUN	конечный_NOUN
raise_VERB	поднимать_VERB
serious_ADJ	серьезный_ADJ
leg_NOUN	лапка_NOUN
patrick_NOUN	патрик_NOUN
division_NOUN	дивизион_NOUN
motion_NOUN	движение_NOUN
critical_ADJ	критический_ADJ
facebook_NOUN	фейсбук_NOUN
laura_NOUN	лора_NOUN
young_ADJ	молодой_ADJ
cell_NOUN	ячейка_NOUN
colombia_NOUN	колумбий_NOUN
sheriff_NOUN	шериф_NOUN
meter_NOUN	счетчик_NOUN
acquire_VERB	приобрести_VERB
province_NOUN	область_NOUN
argument_NOUN	довод_NOUN
communication_NOUN	связь_NOUN
california_NOUN	калифорния_NOUN
brisbane_NOUN	брисбена_NOUN
modify_VERB	изменять_VERB
family_NOUN	семейство_NOUN
regulation_NOUN	регулирование_NOUN
fund_NOUN	фонд_NOUN
act_NOUN	деяние_NOUN
electronic_ADJ	электронный_ADJ
christopher_NOUN	кристофер_NOUN
frankfurt_NOUN	франкфурт_NOUN
execute_VERB	казнить_VERB
underground_ADJ	подземный_ADJ
write_VERB	писать_VERB
tiger_NOUN	тигр_NOUN
female_ADJ	женский_ADJ
defeate_VERB	побеждать_VERB
universal_ADJ	всеобщий_ADJ
deliver_VERB	доставлять_VERB
trial_NOUN	испытание_NOUN
message_NOUN	сообщение_NOUN
controversial_ADJ	спорный_ADJ
mary_NOUN	махать_NOUN
requirement_NOUN	требование_NOUN
near_ADV	рядом_ADV
newcastle_NOUN	ньюкасл_NOUN
selection_NOUN	выделение_NOUN
rate_NOUN	тариф_NOUN
grandfather_NOUN	дедушка_NOUN
embassy_NOUN	посольство_NOUN
music_NOUN	музыка_NOUN
change_NOUN	изменение_NOUN
chain_NOUN	цепочка_NOUN
form_NOUN	формуляр_NOUN
fort_NOUN	форт_NOUN
individual_NOUN	лицо_NOUN
walter_NOUN	вальтер_NOUN
centuries_NOUN	век_NOUN
pole_NOUN	столб_NOUN
appearances_NOUN	внешность_NOUN
lodge_NOUN	лодж_NOUN
formerly_ADV	ранее_ADV
kid_NOUN	детка_NOUN
calgary_NOUN	калгари_NOUN
quote_NOUN	цитата_NOUN
calculate_VERB	рассчитывать_VERB
harrison_NOUN	харрисон_NOUN
free_ADJ	свободный_ADJ
join_VERB	присоединяться_VERB
deal_NOUN	сделка_NOUN
vote_VERB	голосовать_VERB
tour_NOUN	тур_NOUN
credit_NOUN	балл_NOUN
partnership_NOUN	партнерство_NOUN
florida_NOUN	флорид_NOUN
exception_NOUN	исключение_NOUN
tourism_NOUN	туризм_NOUN
worthy_ADJ	достойный_ADJ
john_NOUN	джон_NOUN
fly_VERB	полет_VERB
hockey_NOUN	хоккей_NOUN
graduate_VERB	оканчивать_VERB
ship_NOUN	суд_NOUN
variety_NOUN	разновидность_NOUN
parking_NOUN	парковка_NOUN
strike_NOUN	удар_NOUN
illness_NOUN	заболевание_NOUN
record_NOUN	рекорд_NOUN
place_NOUN	место_NOUN
defence_NOUN	защита_NOUN
display_NOUN	показ_NOUN
geographic_ADJ	географический_ADJ
connection_NOUN	связь_NOUN
storm_NOUN	шторм_NOUN
tool_NOUN	инструмент_NOUN
truly_ADV	воистину_ADV
technical_ADJ	технический_ADJ
recognise_VERB	признавать_VERB
season_NOUN	сезон_NOUN
share_VERB	делиться_VERB
coast_NOUN	побережье_NOUN
historically_ADV	исторически_ADV
emphasis_NOUN	упор_NOUN
therefore_ADV	поэтому_ADV
interview_NOUN	беседа_NOUN
sentence_NOUN	приговор_NOUN
guard_NOUN	гвардия_NOUN
hunter_NOUN	хантер_NOUN
passing_NOUN	прохождение_NOUN
near_ADV	близко_ADV
commanded_VERB	командовать_VERB
actor_NOUN	субъект_NOUN
german_NOUN	германий_NOUN
issue_VERB	издавать_VERB
walk_VERB	прохаживаться_VERB
overview_NOUN	обзор_NOUN
roosevelt_NOUN	рузвельть_NOUN
hard_ADJ	жесткий_ADJ
branch_NOUN	ветвь_NOUN
foster_NOUN	фостирать_NOUN
way_NOUN	способ_NOUN
flower_NOUN	цветок_NOUN
button_NOUN	кнопка_NOUN
view_NOUN	взгляд_NOUN
already_ADV	уже_ADV
discover_VERB	обнаруживать_VERB
fill_VERB	заполнить_VERB
purchase_VERB	покупать_VERB
grammar_NOUN	грамматика_NOUN
frank_NOUN	франк_NOUN
radio_NOUN	радио_NOUN
novel_NOUN	роман_NOUN
sun_NOUN	солнце_NOUN
debate_NOUN	прения_NOUN
volume_NOUN	том_NOUN
feature_NOUN	особенность_NOUN
help_NOUN	справка_NOUN
compound_NOUN	комплекс_NOUN
recognize_VERB	узнать_VERB
jury_NOUN	жюри_NOUN
hospital_NOUN	госпиталь_NOUN
name_NOUN	название_NOUN
sufficient_ADJ	достаточный_ADJ
assessment_NOUN	оценка_NOUN
schedule_VERB	запланировать_VERB
grey_NOUN	греть_NOUN
nigeria_NOUN	нигерия_NOUN
glass_NOUN	стекло_NOUN
family_NOUN	семья_NOUN
achieve_VERB	достигать_VERB
fit_VERB	подходить_VERB
create_VERB	создаваться_VERB
order_NOUN	орден_NOUN
thousand_NOUN	тысяча_NOUN
toure_VERB	гастролировать_VERB
confirm_VERB	подтверждать_VERB
jennifer_NOUN	дженнифер_NOUN
swedish_ADJ	шведский_ADJ
japanese_ADJ	японский_ADJ
film_NOUN	фильм_NOUN
indian_NOUN	индеец_NOUN
pride_NOUN	гордость_NOUN
pit_NOUN	яма_NOUN
publication_NOUN	публикация_NOUN
protect_VERB	защищать_VERB
baby_NOUN	малыш_NOUN
bulgaria_NOUN	болгария_NOUN
welfare_NOUN	благополучие_NOUN
possibility_NOUN	возможность_NOUN
photography_NOUN	фотография_NOUN
couple_NOUN	пара_NOUN
chemical_ADJ	химический_ADJ
label_NOUN	ярлык_NOUN
useful_ADJ	полезный_ADJ
hate_NOUN	ненависть_NOUN
regiment_NOUN	полка_NOUN
cuisine_NOUN	кухня_NOUN
receive_VERB	получать_VERB
june_NOUN	джун_NOUN
form_VERB	формироваться_VERB
street_NOUN	улица_NOUN
council_NOUN	совет_NOUN
action_NOUN	мера_NOUN
theater_NOUN	театр_NOUN
electrical_ADJ	электрический_ADJ
catholic_NOUN	католик_NOUN
ecuador_NOUN	эквадор_NOUN
section_NOUN	секция_NOUN
stanley_NOUN	стенль_NOUN
pennsylvania_NOUN	пенсильвание_NOUN
acre_NOUN	акр_NOUN
possession_NOUN	хранение_NOUN
conflict_NOUN	коллизия_NOUN
stay_VERB	оставаться_VERB
web_NOUN	веб_NOUN
order_VERB	заказывать_VERB
mon_NOUN	мон_NOUN
review_VERB	рассмотреть_VERB
duty_NOUN	пошлина_NOUN
improvement_NOUN	усовершенствование_NOUN
speaker_NOUN	оратор_NOUN
restrict_VERB	ограничивать_VERB
jan_NOUN	джанин_NOUN
wilson_NOUN	уилсон_NOUN
pope_NOUN	поуп_NOUN
surprise_NOUN	сюрприз_NOUN
instrumental_ADJ	инструментальный_ADJ
practice_NOUN	практика_NOUN
clay_NOUN	клэй_NOUN
describe_VERB	описать_VERB
damage_NOUN	повреждение_NOUN
roof_NOUN	крыша_NOUN
dress_NOUN	платье_NOUN
sea_NOUN	море_NOUN
older_ADJ	старший_ADJ
focus_NOUN	внимание_NOUN
animal_NOUN	зверь_NOUN
cyprus_NOUN	кипр_NOUN
unique_ADJ	уникальный_ADJ
expansion_NOUN	расширение_NOUN
photograph_NOUN	фотография_NOUN
five_NUM	пятеро_NUM
film_NOUN	кино_NOUN
continue_VERB	продолжаться_VERB
federal_ADJ	федеральный_ADJ
release_NOUN	релиз_NOUN
impression_NOUN	впечатление_NOUN
winter_NOUN	зимний_NOUN
draw_VERB	нарисовать_VERB
merit_NOUN	заслуга_NOUN
depression_NOUN	депрессия_NOUN
venue_NOUN	площадка_NOUN
bring_VERB	приводить_VERB
warm_ADJ	теплый_ADJ
coach_NOUN	тренер_NOUN
tony_NOUN	тоня_NOUN
distribution_NOUN	распространение_NOUN
divide_VERB	разделяться_VERB
couple_NOUN	парочка_NOUN
possession_NOUN	обладание_NOUN
inquiry_NOUN	расследование_NOUN
thorough_ADJ	тщательный_ADJ
turn_VERB	поворачиваться_VERB
floor_NOUN	этаж_NOUN
franchise_NOUN	франшиза_NOUN
station_NOUN	станция_NOUN
garrison_NOUN	гарнизон_NOUN
membership_NOUN	членство_NOUN
compil_VERB	составлять_VERB
fill_NOUN	заполнение_NOUN
plate_NOUN	плита_NOUN
original_ADJ	оригинальный_ADJ
edition_NOUN	издание_NOUN
ceremony_NOUN	церемония_NOUN
descendant_NOUN	потомок_NOUN
danny_NOUN	дэнь_NOUN
cameron_NOUN	кэмерон_NOUN
arthur_NOUN	артур_NOUN
baptist_NOUN	баптист_NOUN
pick_VERB	выбирать_VERB
experimental_ADJ	экспериментальный_ADJ
town_NOUN	город_NOUN
sometimes_ADV	иногда_ADV
gas_NOUN	газ_NOUN
martin_NOUN	мартина_NOUN
spring_NOUN	весна_NOUN
nation_NOUN	нация_NOUN
garden_NOUN	сад_NOUN
youngest_ADJ	младший_ADJ
colin_NOUN	колин_NOUN
singles_NOUN	разряд_NOUN
move_VERB	перемещать_VERB
cleanup_NOUN	очистка_NOUN
soundtrack_NOUN	саундтрек_NOUN
committee_NOUN	комитет_NOUN
general_NOUN	генерал_NOUN
celebrate_VERB	отмечать_VERB
height_NOUN	рост_NOUN
park_NOUN	парк_NOUN
teaching_NOUN	преподавание_NOUN
cold_ADJ	холодный_ADJ
main_ADJ	главный_ADJ
travel_NOUN	проезд_NOUN
pay_VERB	платить_VERB
snow_NOUN	снег_NOUN
feed_NOUN	лента_NOUN
entity_NOUN	образование_NOUN
observation_NOUN	замечание_NOUN
swimmer_NOUN	пловец_NOUN
texa_NOUN	техасы_NOUN
volume_NOUN	громкость_NOUN
ranger_NOUN	рейнджер_NOUN
basketball_NOUN	баскетбол_NOUN
european_ADJ	европейский_ADJ
senior_ADJ	старший_ADJ
approval_NOUN	одобрение_NOUN
poet_NOUN	поэт_NOUN
reviewer_NOUN	рецензент_NOUN
shaw_NOUN	шоу_NOUN
owner_NOUN	хозяин_NOUN
change_VERB	меняться_VERB
then_ADV	потом_ADV
austria_NOUN	австрия_NOUN
stop_VERB	переставать_VERB
operation_NOUN	эксплуатация_NOUN
have_VERB	иметь_VERB
gap_NOUN	пробел_NOUN
broad_ADJ	широкий_ADJ
lisa_NOUN	лиза_NOUN
african_NOUN	африка_NOUN
threat_NOUN	угроза_NOUN
stone_NOUN	камень_NOUN
start_NOUN	старт_NOUN
workshop_NOUN	семинар_NOUN
guy_NOUN	ребята_NOUN
vote_VERB	проголосовать_VERB
url_NOUN	урл_NOUN
violent_ADJ	насильственный_ADJ
pronounce_VERB	выражать_VERB
display_VERB	выставлять_VERB
brain_NOUN	мозг_NOUN
intermediate_ADJ	промежуточный_ADJ
service_NOUN	услуга_NOUN
contest_NOUN	евровидений_NOUN
denis_NOUN	день_NOUN
conservation_NOUN	сохранение_NOUN
ways_NOUN	способ_NOUN
marry_VERB	жениться_VERB
superior_ADJ	высший_ADJ
somewhat_ADV	несколько_ADV
return_VERB	вернуться_VERB
arm_NOUN	вооружение_NOUN
phase_NOUN	этап_NOUN
audience_NOUN	зритель_NOUN
syndrome_NOUN	синдром_NOUN
print_VERB	распечатывать_VERB
presence_NOUN	присутствие_NOUN
chi_NOUN	чи_NOUN
win_VERB	выигрывать_VERB
samuel_NOUN	самуэль_NOUN
location_NOUN	место_NOUN
they_PRON	они_PRON
box_NOUN	коробка_NOUN
award_NOUN	премия_NOUN
fort_NOUN	крепость_NOUN
scheme_NOUN	схема_NOUN
student_NOUN	учащийся_NOUN
midfielder_NOUN	полузащитник_NOUN
difference_NOUN	отличие_NOUN
branch_NOUN	ветка_NOUN
gary_NOUN	гарь_NOUN
power_NOUN	мощь_NOUN
journal_NOUN	журнал_NOUN
response_NOUN	реагирование_NOUN
cricket_NOUN	крикет_NOUN
robert_NOUN	робертс_NOUN
dawn_NOUN	рассвет_NOUN
tone_NOUN	тон_NOUN
automatic_ADJ	автоматический_ADJ
depend_VERB	зависеть_VERB
hollywood_NOUN	голливуд_NOUN
characteristic_NOUN	особенность_NOUN
guide_NOUN	гид_NOUN
cardiff_NOUN	кардифф_NOUN
scene_NOUN	сцена_NOUN
basic_ADJ	основной_ADJ
authority_NOUN	власть_NOUN
end_VERB	заканчиваться_VERB
commune_NOUN	коммун_NOUN
payment_NOUN	платеж_NOUN
consist_VERB	состоять_VERB
genetic_ADJ	генетический_ADJ
normal_ADJ	обычный_ADJ
number_NOUN	число_NOUN
king_NOUN	кинг_NOUN
peak_NOUN	пик_NOUN
arrive_VERB	прибывать_VERB
survey_NOUN	опрос_NOUN
dean_NOUN	декан_NOUN
act_VERB	действовать_VERB
maintenance_NOUN	поддержание_NOUN
surname_NOUN	фамилия_NOUN
blood_NOUN	кровь_NOUN
leave_VERB	покидать_VERB
bring_VERB	приносить_VERB
scientific_ADJ	научный_ADJ
other_ADJ	прочий_ADJ
room_NOUN	комната_NOUN
worker_NOUN	трудящийся_NOUN
fame_NOUN	слава_NOUN
nick_NOUN	никакой_NOUN
empire_NOUN	империя_NOUN
conductor_NOUN	дирижер_NOUN
friendly_ADJ	дружелюбный_ADJ
squadron_NOUN	эскадрилье_NOUN
translation_NOUN	перевод_NOUN
matthew_NOUN	мэтть_NOUN
much_ADV	много_ADV
flight_NOUN	бегство_NOUN
safety_NOUN	безопасность_NOUN
waste_NOUN	отходы_NOUN
disaster_NOUN	бедствие_NOUN
debate_NOUN	дебаты_NOUN
word_NOUN	слово_NOUN
tribute_NOUN	должное_NOUN
supply_NOUN	поставка_NOUN
remove_VERB	удаляться_VERB
gun_NOUN	оружие_NOUN
direction_NOUN	направление_NOUN
valid_ADJ	действительный_ADJ
cardinal_NOUN	кардинал_NOUN
grow_VERB	расти_VERB
basic_ADJ	базовый_ADJ
successfully_ADV	успешно_ADV
signature_NOUN	подпись_NOUN
prague_NOUN	праг_NOUN
success_NOUN	успех_NOUN
violation_NOUN	нарушение_NOUN
discipline_NOUN	дисциплина_NOUN
face_NOUN	лицо_NOUN
vision_NOUN	зрение_NOUN
sell_VERB	продаваться_VERB
phone_NOUN	телефон_NOUN
bed_NOUN	кровать_NOUN
block_NOUN	блокировка_NOUN
almost_ADV	почти_ADV
reporter_NOUN	репортер_NOUN
craig_NOUN	крейг_NOUN
depend_VERB	смотреть_VERB
attention_NOUN	внимание_NOUN
rare_ADJ	редкий_ADJ
accident_NOUN	дтп_NOUN
racing_NOUN	гонка_NOUN
union_NOUN	юнион_NOUN
representative_NOUN	представитель_NOUN
session_NOUN	сеанс_NOUN
leg_NOUN	ген_NOUN
promotional_ADJ	рекламный_ADJ
confusion_NOUN	путаница_NOUN
region_NOUN	область_NOUN
poem_NOUN	стих_NOUN
schedule_NOUN	расписание_NOUN
bridge_NOUN	бридж_NOUN
claim_NOUN	претензия_NOUN
artillery_NOUN	артиллерия_NOUN
boston_NOUN	бостон_NOUN
prison_NOUN	тюрьма_NOUN
lose_VERB	терять_VERB
target_NOUN	мишень_NOUN
economy_NOUN	экономика_NOUN
stock_NOUN	акция_NOUN
gordon_NOUN	гордон_NOUN
theory_NOUN	теория_NOUN
exile_NOUN	изгнание_NOUN
airline_NOUN	авиалиния_NOUN
vietnam_NOUN	вьетн_NOUN
exclusive_ADJ	эксклюзивный_ADJ
