boyfriend_NOUN	парень_NOUN
malayalam_NOUN	малаял_NOUN
drawing_NOUN	рисунок_NOUN
broadcast_NOUN	трансляция_NOUN
missionary_NOUN	миссионер_NOUN
curtis_NOUN	кёртис_NOUN
logical_ADJ	логический_ADJ
translation_NOUN	перевод_NOUN
insert_VERB	включить_VERB
blair_NOUN	блэр_NOUN
shrine_NOUN	святилище_NOUN
yankee_NOUN	янки_NOUN
shoe_NOUN	туфля_NOUN
corn_NOUN	кукуруза_NOUN
provider_NOUN	поставщик_NOUN
sacrifice_NOUN	жертвоприношение_NOUN
strict_ADJ	строгий_ADJ
tel_NOUN	тело_NOUN
tang_NOUN	тан_NOUN
geoffrey_NOUN	джефри_NOUN
supposedly_ADV	предположительно_ADV
consistently_ADV	последовательно_ADV
distant_ADJ	отдаленный_ADJ
varietie_NOUN	сорт_NOUN
strait_NOUN	пролив_NOUN
humor_NOUN	юмор_NOUN
monk_NOUN	монк_NOUN
reform_NOUN	реформа_NOUN
evangelical_ADJ	евангелический_ADJ
aid_NOUN	спид_NOUN
plane_NOUN	плоскость_NOUN
prehistoric_ADJ	доисторическая_ADJ
claire_NOUN	клэр_NOUN
suburban_ADJ	пригородный_ADJ
relay_NOUN	реле_NOUN
molecule_NOUN	молекула_NOUN
remember_VERB	вспоминать_VERB
george_NOUN	жорж_NOUN
lengthy_ADJ	длительный_ADJ
elephant_NOUN	слон_NOUN
concerto_NOUN	концерт_NOUN
trick_NOUN	уловка_NOUN
holder_NOUN	держатель_NOUN
monkey_NOUN	обезьяна_NOUN
graph_NOUN	график_NOUN
present_VERB	представлять_VERB
proportion_NOUN	пропорция_NOUN
engagement_NOUN	вовлечение_NOUN
aggressive_ADJ	агрессивный_ADJ
cleaning_NOUN	чистка_NOUN
shirt_NOUN	футболка_NOUN
battalion_NOUN	батальон_NOUN
particle_NOUN	частица_NOUN
silva_NOUN	силво_NOUN
array_NOUN	массив_NOUN
finding_NOUN	вывод_NOUN
milton_NOUN	милтон_NOUN
bag_NOUN	сумка_NOUN
spot_VERB	замечать_VERB
gravity_NOUN	гравитация_NOUN
regiment_NOUN	полк_NOUN
header_NOUN	заголовок_NOUN
ignore_VERB	проигнорировать_VERB
drawing_NOUN	чертеж_NOUN
dot_NOUN	дот_NOUN
jessican_NOUN	джессика_NOUN
retreat_NOUN	отступление_NOUN
dimension_NOUN	измерение_NOUN
tehran_NOUN	тегерана_NOUN
silk_NOUN	шелк_NOUN
scale_NOUN	шкала_NOUN
like_VERB	нравиться_VERB
spot_NOUN	ролик_NOUN
bonds_NOUN	облигация_NOUN
astronomy_NOUN	астрономия_NOUN
questionable_ADJ	сомнительный_ADJ
surrey_NOUN	суррь_NOUN
fountain_NOUN	фонтан_NOUN
dust_NOUN	пыль_NOUN
instructor_NOUN	инструктор_NOUN
jeffrey_NOUN	джефри_NOUN
chave_NOUN	чадо_NOUN
privately_ADV	наедине_ADV
cream_NOUN	крем_NOUN
fake_NOUN	подделка_NOUN
humanity_NOUN	человечность_NOUN
cloth_NOUN	одежда_NOUN
wet_ADJ	мокрый_ADJ
variant_NOUN	вариант_NOUN
reliability_NOUN	достоверность_NOUN
tough_ADJ	жесткий_ADJ
rafael_NOUN	рафаэль_NOUN
disband_VERB	расформировать_VERB
transformation_NOUN	трансформация_NOUN
rap_NOUN	рэп_NOUN
sailor_NOUN	моряк_NOUN
joke_NOUN	шутка_NOUN
allegedly_ADV	якобы_ADV
commander_NOUN	командир_NOUN
diplomat_NOUN	дипломат_NOUN
screenwriter_NOUN	сценарист_NOUN
telugu_NOUN	телуга_NOUN
salem_NOUN	салть_NOUN
costume_NOUN	костюм_NOUN
edge_NOUN	край_NOUN
clean_VERB	почистить_VERB
problematic_ADJ	проблематичный_ADJ
compromise_NOUN	компромисс_NOUN
arrow_NOUN	стрела_NOUN
finalist_NOUN	финалист_NOUN
baldwin_NOUN	болдуин_NOUN
dale_NOUN	дэйл_NOUN
brilliant_ADJ	блестящий_ADJ
careful_ADJ	осторожный_ADJ
raider_NOUN	рейдер_NOUN
palomar_NOUN	паломар_NOUN
dozen_NOUN	дюжина_NOUN
switch_VERB	менять_VERB
decease_VERB	скончаться_VERB
client_NOUN	клиент_NOUN
arbitrator_NOUN	арбитр_NOUN
marking_NOUN	маркировка_NOUN
humanity_NOUN	человечество_NOUN
carnegie_NOUN	карнега_NOUN
motor_NOUN	двигатель_NOUN
nurse_NOUN	медсестра_NOUN
illustrate_VERB	иллюстрировать_VERB
cleaning_NOUN	уборка_NOUN
millennium_NOUN	тысячелетие_NOUN
linda_NOUN	линда_NOUN
girlfriend_NOUN	подруга_NOUN
lineup_NOUN	опознаний_NOUN
ibm_X	ибм_X
explosion_NOUN	взрыв_NOUN
documentation_NOUN	документация_NOUN
louisville_NOUN	луисвилла_NOUN
fur_NOUN	шерсть_NOUN
olive_ADJ	оливковый_ADJ
million_NOUN	миллион_NOUN
ignore_VERB	игнорировать_VERB
egg_NOUN	яйцо_NOUN
reflect_VERB	отразить_VERB
norton_NOUN	нортон_NOUN
ammunition_NOUN	боеприпас_NOUN
chave_NOUN	чед_NOUN
elevate_VERB	повышать_VERB
telegraph_NOUN	телеграф_NOUN
tune_NOUN	мелодия_NOUN
mohammad_NOUN	мохаммед_NOUN
surface_NOUN	поверхность_NOUN
insufficient_ADJ	недостаточный_ADJ
light_NOUN	молния_NOUN
consequently_ADV	следовательно_ADV
plate_NOUN	пластина_NOUN
permanently_ADV	навсегда_ADV
providence_NOUN	провиденс_NOUN
commitment_NOUN	обязательство_NOUN
love_VERB	любить_VERB
brighton_NOUN	брайтон_NOUN
succeed_VERB	преуспевать_VERB
monkey_NOUN	обезьянка_NOUN
wheel_NOUN	колесо_NOUN
criterion_NOUN	критерий_NOUN
compensation_NOUN	компенсация_NOUN
likewise_ADV	аналогично_ADV
productive_ADJ	продуктивный_ADJ
creature_NOUN	тварь_NOUN
honor_VERB	заслуживать_VERB
spa_NOUN	спа_NOUN
endorse_VERB	одобрять_VERB
clara_NOUN	клара_NOUN
ulster_NOUN	ольстер_NOUN
enterprise_NOUN	предприятие_NOUN
ball_NOUN	яйцо_NOUN
napoleon_NOUN	наполеон_NOUN
contract_NOUN	договор_NOUN
sanction_NOUN	санкция_NOUN
enable_VERB	включить_VERB
ham_NOUN	ветчина_NOUN
decorate_VERB	украшать_VERB
furniture_NOUN	мебель_NOUN
slavery_NOUN	рабство_NOUN
employer_NOUN	заказчик_NOUN
libya_NOUN	ливии_NOUN
minimal_ADJ	минимальный_ADJ
pond_NOUN	пруд_NOUN
definition_NOUN	определение_NOUN
grave_NOUN	могила_NOUN
advise_VERB	советовать_VERB
chocolate_NOUN	шоколад_NOUN
useless_ADJ	бесполезный_ADJ
kerry_NOUN	керри_NOUN
slovakia_NOUN	словакие_NOUN
finger_NOUN	палец_NOUN
armor_NOUN	броня_NOUN
rotation_NOUN	вращение_NOUN
scandal_NOUN	скандал_NOUN
claire_NOUN	клирать_NOUN
cage_NOUN	клетка_NOUN
gain_VERB	набирать_VERB
pursuit_NOUN	погоня_NOUN
defender_NOUN	правозащитник_NOUN
penn_NOUN	пенна_NOUN
conquest_NOUN	завоевание_NOUN
moderate_ADJ	умерять_ADJ
thunder_NOUN	гром_NOUN
designer_NOUN	дизайнер_NOUN
nest_NOUN	гнездо_NOUN
griffin_NOUN	гриффин_NOUN
ceiling_NOUN	потолок_NOUN
count_VERB	насчитывать_VERB
investigate_VERB	расследовать_VERB
speculation_NOUN	спекуляция_NOUN
pleasant_ADJ	приятный_ADJ
logo_NOUN	логотип_NOUN
specimen_NOUN	экземпляр_NOUN
die_VERB	умирать_VERB
avoid_VERB	избегать_VERB
hall_NOUN	зал_NOUN
mess_NOUN	бардак_NOUN
detection_NOUN	обнаружение_NOUN
csd_NOUN	курица_NOUN
firm_NOUN	фирма_NOUN
investor_NOUN	инвестор_NOUN
physician_NOUN	врач_NOUN
fringe_NOUN	грань_NOUN
legally_ADV	легально_ADV
bach_NOUN	баха_NOUN
subway_NOUN	метро_NOUN
darkness_NOUN	мрак_NOUN
penalty_NOUN	штраф_NOUN
receptor_NOUN	рецептор_NOUN
trainer_NOUN	тренер_NOUN
emerg_VERB	возникать_VERB
rifle_NOUN	винтовка_NOUN
maker_NOUN	создатель_NOUN
harder_ADJ	тяжелый_ADJ
rosa_NOUN	роза_NOUN
mentor_NOUN	наставник_NOUN
beatle_NOUN	битлз_NOUN
bow_NOUN	лук_NOUN
stronger_ADJ	крепкий_ADJ
interaction_NOUN	взаимодействие_NOUN
trilogy_NOUN	трилогия_NOUN
catalogue_NOUN	каталог_NOUN
plantation_NOUN	плантация_NOUN
mechanic_NOUN	механика_NOUN
fusion_NOUN	синтез_NOUN
dinner_NOUN	ужин_NOUN
lat_NOUN	лата_NOUN
carefully_ADV	бережно_ADV
strategy_NOUN	стратегия_NOUN
circulation_NOUN	тираж_NOUN
demonstration_NOUN	демонстрация_NOUN
brandon_NOUN	брэндон_NOUN
witness_NOUN	свидетель_NOUN
entrepreneur_NOUN	предприниматель_NOUN
consequence_NOUN	следствие_NOUN
vulnerable_ADJ	уязвимый_ADJ
hole_NOUN	дырка_NOUN
exterior_ADJ	внешний_ADJ
chamber_NOUN	камера_NOUN
consultant_NOUN	консультант_NOUN
marine_NOUN	морпех_NOUN
bomber_NOUN	бомбардировщик_NOUN
roberto_NOUN	роберто_NOUN
foundation_NOUN	основа_NOUN
fire_NOUN	пожар_NOUN
cleare_VERB	очистить_VERB
reflect_VERB	отражать_VERB
bulletin_NOUN	бюллетень_NOUN
supporter_NOUN	сторонник_NOUN
cream_NOUN	сливки_NOUN
raja_NOUN	радж_NOUN
performer_NOUN	исполнитель_NOUN
patricia_NOUN	патриций_NOUN
wagner_NOUN	вагнирать_NOUN
servant_NOUN	служанка_NOUN
jesse_NOUN	джесси_NOUN
accidentally_ADV	нечаянно_ADV
heart_NOUN	сердце_NOUN
compound_NOUN	соединение_NOUN
electron_NOUN	электрон_NOUN
reaction_NOUN	реакция_NOUN
outline_ADV	набросок_ADV
forbe_NOUN	форбса_NOUN
darwin_NOUN	дарвин_NOUN
night_NOUN	ночь_NOUN
legend_NOUN	легенда_NOUN
impressed_ADJ	впечатлять_ADJ
pregnant_ADJ	беременная_ADJ
sculptor_NOUN	скульптор_NOUN
acknowledge_VERB	признавать_VERB
runway_NOUN	подиум_NOUN
dynamics_NOUN	динамик_NOUN
sphere_NOUN	сфера_NOUN
exception_NOUN	изъятие_NOUN
bit_NOUN	бит_NOUN
disorder_NOUN	расстройство_NOUN
paste_VERB	вставить_VERB
dimension_NOUN	размер_NOUN
panel_NOUN	панель_NOUN
czechoslovakia_NOUN	чехословакия_NOUN
timothy_NOUN	тимоть_NOUN
carpenter_NOUN	карпентирать_NOUN
churchill_NOUN	черчилль_NOUN
monroe_NOUN	монро_NOUN
bench_NOUN	скамейка_NOUN
corridor_NOUN	коридор_NOUN
maharashtra_NOUN	махараштр_NOUN
detection_NOUN	выявление_NOUN
boom_NOUN	бум_NOUN
governorate_NOUN	мухафаза_NOUN
bunch_NOUN	кучка_NOUN
optical_ADJ	оптический_ADJ
syracuse_NOUN	сиракуз_NOUN
loading_NOUN	погрузка_NOUN
shelter_NOUN	приют_NOUN
holme_NOUN	холмс_NOUN
linguistic_ADJ	языковой_ADJ
martha_NOUN	март_NOUN
batman_NOUN	бэтмен_NOUN
teen_NOUN	подросток_NOUN
export_NOUN	экспорт_NOUN
collaborate_VERB	сотрудничать_VERB
nurse_NOUN	сестра_NOUN
invention_NOUN	изобретение_NOUN
duration_NOUN	продолжительность_NOUN
fraser_NOUN	фрейзер_NOUN
prevention_NOUN	профилактика_NOUN
greene_NOUN	грин_NOUN
apartment_NOUN	квартира_NOUN
pablo_NOUN	пабло_NOUN
ion_NOUN	ион_NOUN
lecturer_NOUN	лектор_NOUN
rhode_NOUN	роудс_NOUN
flag_NOUN	флаг_NOUN
ray_NOUN	луч_NOUN
edmund_NOUN	эдмунда_NOUN
infection_NOUN	инфекция_NOUN
accident_NOUN	дтп_NOUN
derek_NOUN	дерека_NOUN
collect_NOUN	сбор_NOUN
provider_NOUN	провайдер_NOUN
invitation_NOUN	приглашение_NOUN
like_VERB	понравиться_VERB
twentieth_NOUN	двадцатый_NOUN
muscle_NOUN	мускул_NOUN
ahmad_NOUN	ахмад_NOUN
striker_NOUN	нападающий_NOUN
dorothy_NOUN	дороть_NOUN
investigation_NOUN	расследование_NOUN
relatife_NOUN	родственник_NOUN
algeria_NOUN	алжироко_NOUN
latvia_NOUN	латвия_NOUN
empress_NOUN	императрица_NOUN
perception_NOUN	восприятие_NOUN
remark_NOUN	замечание_NOUN
potter_NOUN	поттер_NOUN
naple_NOUN	неаполь_NOUN
madagascar_NOUN	мадагаскар_NOUN
laser_NOUN	лазер_NOUN
bacteria_NOUN	бактерия_NOUN
cliff_NOUN	клифф_NOUN
render_VERB	выносить_VERB
correspondence_NOUN	корреспонденция_NOUN
response_NOUN	ответ_NOUN
cairo_NOUN	каир_NOUN
lang_NOUN	лэнгать_NOUN
cooking_NOUN	приготовление_NOUN
informal_ADJ	неформальный_ADJ
leon_NOUN	леон_NOUN
convention_NOUN	конвенция_NOUN
hypothesis_NOUN	гипотеза_NOUN
wal_NOUN	уолть_NOUN
favourite_ADJ	любимый_ADJ
deliberately_ADV	преднамеренно_ADV
acre_NOUN	акр_NOUN
cambodia_NOUN	камбодж_NOUN
sheep_NOUN	овца_NOUN
chip_NOUN	чип_NOUN
spot_NOUN	пятно_NOUN
fee_NOUN	сборы_NOUN
religion_NOUN	религия_NOUN
birth_NOUN	род_NOUN
cruise_NOUN	круз_NOUN
affiliate_NOUN	филиал_NOUN
mayor_NOUN	мэр_NOUN
servant_NOUN	слуга_NOUN
beetle_NOUN	жук_NOUN
bolivia_NOUN	боливие_NOUN
assassination_NOUN	убийство_NOUN
landmark_NOUN	достопримечательность_NOUN
explore_VERB	исследовать_VERB
manufacture_NOUN	изготовление_NOUN
withdrawal_NOUN	снятие_NOUN
sensitive_ADJ	чувствительный_ADJ
rescue_VERB	спасать_VERB
tube_NOUN	трубка_NOUN
diving_NOUN	погружение_NOUN
paste_VERB	вставлять_VERB
revolt_NOUN	бунт_NOUN
garcia_NOUN	гарсиа_NOUN
governance_NOUN	управление_NOUN
dozen_NOUN	десяток_NOUN
monica_NOUN	моника_NOUN
switch_VERB	поменяться_VERB
strictly_ADV	строго_ADV
jake_NOUN	джейк_NOUN
ace_NOUN	эйс_NOUN
troop_NOUN	войска_NOUN
deliberately_ADV	умышленно_ADV
accidentally_ADV	случайно_ADV
connor_NOUN	коннора_NOUN
revolt_NOUN	мятеж_NOUN
agreement_NOUN	соглашение_NOUN
correspondence_NOUN	переписка_NOUN
hood_NOUN	художественный_NOUN
toy_NOUN	игрушка_NOUN
prof_NOUN	профессор_NOUN
proximity_NOUN	близость_NOUN
nowhere_ADV	некуда_ADV
memory_NOUN	воспоминание_NOUN
duration_NOUN	длительность_NOUN
nose_NOUN	нос_NOUN
apply_VERB	применять_VERB
realm_NOUN	царство_NOUN
defender_NOUN	защитник_NOUN
fac_NOUN	квс_NOUN
mysterious_ADJ	загадочный_ADJ
squadron_NOUN	эскадрилья_NOUN
reserve_VERB	защищать_VERB
gallery_NOUN	галерея_NOUN
classic_NOUN	классика_NOUN
salmon_NOUN	лосось_NOUN
deer_NOUN	олень_NOUN
ending_NOUN	окончание_NOUN
aunt_NOUN	тетя_NOUN
kyle_NOUN	кайть_NOUN
misleading_NOUN	заблуждение_NOUN
eugene_NOUN	евгения_NOUN
bike_NOUN	велосипед_NOUN
bedford_NOUN	бедфорд_NOUN
slight_ADJ	незначительный_ADJ
savage_NOUN	дикарь_NOUN
luther_NOUN	лютирать_NOUN
edgar_NOUN	эдгар_NOUN
lon_NOUN	лон_NOUN
copy_VERB	скопировать_VERB
rachel_NOUN	рейчеловек_NOUN
brussel_NOUN	брюссель_NOUN
graph_NOUN	граф_NOUN
venus_NOUN	венера_NOUN
personalitie_NOUN	деятель_NOUN
mechanism_NOUN	механизм_NOUN
paradise_NOUN	рай_NOUN
rhine_NOUN	рейн_NOUN
unanimous_ADJ	единогласный_ADJ
bigger_ADJ	крупный_ADJ
pace_NOUN	темп_NOUN
dylan_NOUN	дилан_NOUN
arrangement_NOUN	договоренность_NOUN
bot_NOUN	бот_NOUN
garcia_NOUN	гарсия_NOUN
sin_NOUN	син_NOUN
ain_NOUN	айн_NOUN
prohibit_VERB	запрещать_VERB
cruise_NOUN	круиз_NOUN
equity_NOUN	справедливость_NOUN
sail_VERB	уплыть_VERB
extraordinary_ADJ	чрезвычайный_ADJ
clinic_NOUN	клиника_NOUN
magical_ADJ	волшебный_ADJ
puppet_NOUN	марионетка_NOUN
darkness_NOUN	тьма_NOUN
lighthouse_NOUN	маяк_NOUN
licensing_NOUN	лицензирование_NOUN
hopkin_NOUN	хопкинс_NOUN
promise_VERB	обещать_VERB
arrow_NOUN	стрелка_NOUN
hybrid_NOUN	гибрид_NOUN
barrier_NOUN	барьер_NOUN
ana_NOUN	ать_NOUN
insert_VERB	вставлять_VERB
biography_NOUN	биография_NOUN
quantity_NOUN	количество_NOUN
affiliation_NOUN	принадлежность_NOUN
grant_NOUN	субсидия_NOUN
pay_VERB	платить_VERB
builder_NOUN	строитель_NOUN
prevention_NOUN	предупреждение_NOUN
boyfriend_NOUN	бойфренд_NOUN
glenn_NOUN	гленна_NOUN
atla_NOUN	атлас_NOUN
tissue_NOUN	ткань_NOUN
tonight_NOUN	вечер_NOUN
mann_NOUN	манна_NOUN
crucial_ADJ	важный_ADJ
trick_NOUN	трюк_NOUN
sick_ADJ	больная_ADJ
nephew_NOUN	племянник_NOUN
shot_NOUN	выстрел_NOUN
probability_NOUN	вероятность_NOUN
charleston_NOUN	чарльстон_NOUN
semifinal_NOUN	полуфинал_NOUN
tanzania_NOUN	танзание_NOUN
discontinue_VERB	прекращать_VERB
eurovision_NOUN	конкурс_NOUN
throw_VERB	бросать_VERB
slovak_NOUN	словацкий_NOUN
explorer_NOUN	исследователь_NOUN
julia_NOUN	джулия_NOUN
tyler_NOUN	тайлер_NOUN
innocent_ADJ	невинный_ADJ
equity_NOUN	равенство_NOUN
module_NOUN	модуль_NOUN
collector_NOUN	коллекционер_NOUN
fight_NOUN	драка_NOUN
cairo_NOUN	каирокий_NOUN
paragraph_NOUN	пункт_NOUN
canterbury_NOUN	кентерберь_NOUN
repeat_VERB	повторить_VERB
lancaster_NOUN	ланкастирать_NOUN
agree_VERB	соглашаться_VERB
diversity_NOUN	разнообразие_NOUN
porter_NOUN	портер_NOUN
provision_NOUN	положение_NOUN
unofficial_ADJ	неофициальный_ADJ
diana_NOUN	диан_NOUN
camera_NOUN	камера_NOUN
myth_NOUN	миф_NOUN
opera_NOUN	опера_NOUN
tension_NOUN	напряжение_NOUN
grandmother_NOUN	бабушка_NOUN
transformation_NOUN	преобразование_NOUN
terror_NOUN	террор_NOUN
browser_NOUN	браузер_NOUN
jung_NOUN	чжон_NOUN
libya_NOUN	ливия_NOUN
rival_NOUN	соперник_NOUN
jump_NOUN	прыжок_NOUN
armie_NOUN	армия_NOUN
shelter_NOUN	укрытие_NOUN
burn_VERB	гореть_VERB
stefan_NOUN	стефан_NOUN
transport_VERB	перевозить_VERB
puppet_NOUN	кукла_NOUN
crater_NOUN	кратер_NOUN
gene_NOUN	ген_NOUN
integrity_NOUN	добросовестность_NOUN
webster_NOUN	вебстер_NOUN
walk_VERB	ходить_VERB
marion_NOUN	марион_NOUN
decrease_NOUN	уменьшение_NOUN
cornell_NOUN	корнелла_NOUN
feeding_NOUN	кормление_NOUN
pipe_NOUN	труба_NOUN
counsel_NOUN	адвокат_NOUN
fluid_NOUN	жидкость_NOUN
springfield_NOUN	спрингфилд_NOUN
wonderful_ADJ	чудесный_ADJ
barrel_NOUN	ствол_NOUN
supplement_NOUN	дополнение_NOUN
melody_NOUN	мелодь_NOUN
shelter_NOUN	жилье_NOUN
explain_VERB	объяснять_VERB
southampton_NOUN	аутгемптоть_NOUN
promise_VERB	пообещать_VERB
acclaim_VERB	признавать_VERB
licence_NOUN	лицензия_NOUN
short_NOUN	шорты_NOUN
tracking_NOUN	отслеживание_NOUN
cry_VERB	плакать_VERB
loyal_ADJ	верный_ADJ
haye_NOUN	хейс_NOUN
autobiography_NOUN	автобиография_NOUN
zone_NOUN	зона_NOUN
bit_NOUN	кусочек_NOUN
treasure_NOUN	клад_NOUN
stan_NOUN	стена_NOUN
maya_NOUN	майя_NOUN
bombardment_NOUN	бомбардировка_NOUN
chest_NOUN	сундук_NOUN
discrimination_NOUN	дискриминация_NOUN
vicinity_NOUN	окрестность_NOUN
pursuit_NOUN	преследование_NOUN
armament_NOUN	вооружение_NOUN
mature_ADJ	зрелый_ADJ
afghan_ADJ	афганский_ADJ
practice_VERB	практиковать_VERB
prove_VERB	доказывать_VERB
snake_NOUN	змея_NOUN
screenplay_NOUN	сценарий_NOUN
eurovision_NOUN	евровидений_NOUN
guide_VERB	управлять_VERB
bullet_NOUN	пуля_NOUN
baltic_ADJ	балтийский_ADJ
papua_NOUN	папуа_NOUN
lecturer_NOUN	преподаватель_NOUN
catholicism_NOUN	католицизм_NOUN
swing_NOUN	качели_NOUN
excess_NOUN	превышение_NOUN
lucy_NOUN	люси_NOUN
illustration_NOUN	иллюстрация_NOUN
admission_NOUN	допуск_NOUN
jackie_NOUN	джек_NOUN
coordinator_NOUN	координатор_NOUN
pollution_NOUN	загрязнение_NOUN
allegedly_ADV	предположительно_ADV
filmography_NOUN	фильмография_NOUN
plain_NOUN	равнина_NOUN
grant_NOUN	дотация_NOUN
plate_NOUN	тарелка_NOUN
float_VERB	плавать_VERB
comedian_NOUN	комик_NOUN
monarchy_NOUN	монархия_NOUN
collapse_VERB	рушиться_VERB
gibraltar_NOUN	гибралтара_NOUN
dragon_NOUN	дракон_NOUN
cruiser_NOUN	крейсер_NOUN
certification_NOUN	сертификация_NOUN
considerably_ADV	значительно_ADV
equation_NOUN	уравнение_NOUN
truck_NOUN	грузовик_NOUN
separately_ADV	раздельно_ADV
observation_NOUN	замечание_NOUN
point_VERB	указывать_VERB
steal_VERB	угнать_VERB
feminist_NOUN	феминистка_NOUN
employer_NOUN	работодатель_NOUN
rainfall_NOUN	осадки_NOUN
chest_NOUN	грудь_NOUN
hostile_NOUN	враждебность_NOUN
strike_VERB	поражать_VERB
patron_NOUN	патрон_NOUN
diary_NOUN	дневник_NOUN
guild_NOUN	гильдия_NOUN
deal_NOUN	сделка_NOUN
tenor_NOUN	тенор_NOUN
presenter_NOUN	ведущий_NOUN
adequate_ADJ	достаточный_ADJ
yeah_INTJ	ага_INTJ
moment_NOUN	мгновение_NOUN
publish_VERB	публиковать_VERB
atp_NOUN	спс_NOUN
caroline_NOUN	кэролайн_NOUN
executive_NOUN	руководитель_NOUN
consciousness_NOUN	сознание_NOUN
demon_NOUN	демон_NOUN
geoffrey_NOUN	джеффри_NOUN
critically_ADV	критически_ADV
publish_VERB	опубликовывать_VERB
butterfly_NOUN	бабочка_NOUN
salvador_NOUN	сальвадор_NOUN
rapper_NOUN	рэпер_NOUN
tribune_NOUN	трибуна_NOUN
defend_VERB	защищать_VERB
committee_NOUN	комитет_NOUN
static_NOUN	помехи_NOUN
preference_NOUN	предпочтение_NOUN
wei_INTJ	вэй_INTJ
consent_NOUN	согласие_NOUN
homer_NOUN	гомирать_NOUN
boris_NOUN	борис_NOUN
rivalry_NOUN	соперничество_NOUN
adequate_ADJ	адекватный_ADJ
carve_VERB	вырезать_VERB
prepare_VERB	приготавливаться_VERB
poster_NOUN	плакат_NOUN
finale_NOUN	финал_NOUN
setting_NOUN	настройка_NOUN
listen_VERB	слушать_VERB
introduce_VERB	представлять_VERB
coach_VERB	тренировать_VERB
reynold_NOUN	рейнольдс_NOUN
stan_NOUN	стэн_NOUN
gaelic_ADJ	гэльский_ADJ
distributor_NOUN	дистрибьютор_NOUN
exhibit_VERB	выставлять_VERB
trend_NOUN	тенденция_NOUN
inventor_NOUN	изобретатель_NOUN
chaos_NOUN	хаос_NOUN
bolivia_NOUN	боливии_NOUN
store_VERB	хранить_VERB
forget_VERB	забывать_VERB
wording_NOUN	формулировка_NOUN
girlfriend_NOUN	подружка_NOUN
secular_ADJ	светский_ADJ
girlfriend_NOUN	девушка_NOUN
latvia_NOUN	латвии_NOUN
console_NOUN	консоль_NOUN
adrian_ADJ	эдриена_ADJ
bailey_NOUN	бэйль_NOUN
skill_NOUN	мастерство_NOUN
personalitie_NOUN	личность_NOUN
acceptance_NOUN	признание_NOUN
observation_NOUN	наблюдение_NOUN
casey_NOUN	кэйси_NOUN
philippe_NOUN	филипп_NOUN
pound_NOUN	фунт_NOUN
substantially_ADV	существенно_ADV
climb_NOUN	восхождение_NOUN
lyon_NOUN	лион_NOUN
memphe_NOUN	мемфис_NOUN
stade_NOUN	стад_NOUN
educator_NOUN	воспитатель_NOUN
lecture_NOUN	лекция_NOUN
moderate_ADJ	умеренные_ADJ
separation_NOUN	разделение_NOUN
barely_ADV	едва_ADV
closest_ADJ	ближайший_ADJ
metre_NOUN	метр_NOUN
elimination_NOUN	ликвидация_NOUN
uncertain_ADJ	неопределять_ADJ
faction_NOUN	группировка_NOUN
diving_NOUN	дайвинг_NOUN
muscle_NOUN	мышца_NOUN
triangle_NOUN	треугольник_NOUN
thriller_NOUN	триллер_NOUN
kit_NOUN	кит_NOUN
boxer_NOUN	боксер_NOUN
sofia_NOUN	софия_NOUN
gather_VERB	собирать_VERB
derivative_NOUN	производная_NOUN
nobility_NOUN	благородство_NOUN
pump_NOUN	насос_NOUN
technological_ADJ	технологический_ADJ
tension_NOUN	напряженность_NOUN
description_NOUN	описание_NOUN
sociology_NOUN	социология_NOUN
demand_VERB	требовать_VERB
skill_NOUN	умение_NOUN
santo_NOUN	сантосать_NOUN
limestone_NOUN	известняк_NOUN
annies_NOUN	анний_NOUN
panther_NOUN	пантера_NOUN
bone_NOUN	кость_NOUN
berry_NOUN	берри_NOUN
mose_NOUN	мозес_NOUN
enzyme_NOUN	фермент_NOUN
auxiliary_NOUN	вспомогательный_NOUN
respect_ADJ	уважать_ADJ
rochester_NOUN	рочестер_NOUN
geneva_NOUN	женев_NOUN
evaluation_NOUN	оценка_NOUN
bach_NOUN	бах_NOUN
minneapolis_NOUN	миннеаполис_NOUN
check_VERB	проверять_VERB
terrain_NOUN	местность_NOUN
teenage_NOUN	подросток_NOUN
constructive_ADJ	конструктивный_ADJ
ruin_NOUN	руины_NOUN
karnataka_NOUN	карнатака_NOUN
technically_ADV	формально_ADV
hole_NOUN	дыра_NOUN
marion_NOUN	мэрион_NOUN
annies_NOUN	эннь_NOUN
migration_NOUN	миграция_NOUN
skill_NOUN	навык_NOUN
bassist_NOUN	басистый_NOUN
accident_NOUN	авария_NOUN
national_NOUN	гражданин_NOUN
michelle_NOUN	мишель_NOUN
monte_NOUN	монть_NOUN
prestigious_ADJ	престижный_ADJ
catalog_NOUN	каталог_NOUN
dot_NOUN	точка_NOUN
footage_NOUN	кадр_NOUN
adoption_NOUN	усыновление_NOUN
stamp_NOUN	марка_NOUN
absent_VERB	отсутствовать_VERB
richardson_NOUN	ричардсона_NOUN
stability_NOUN	стабильность_NOUN
naked_ADJ	голый_ADJ
capitol_NOUN	капитолий_NOUN
ahmad_NOUN	ахмед_NOUN
distant_ADJ	дальний_ADJ
equity_NOUN	равноправие_NOUN
audience_NOUN	аудитория_NOUN
julia_NOUN	юлить_NOUN
fairy_NOUN	фея_NOUN
viola_NOUN	виол_NOUN
equality_NOUN	равенство_NOUN
twin_NOUN	близнец_NOUN
tin_NOUN	тин_NOUN
mose_NOUN	моись_NOUN
armor_NOUN	доспехи_NOUN
delay_NOUN	задержка_NOUN
ton_NOUN	тон_NOUN
physically_ADV	физически_ADV
ton_NOUN	тонна_NOUN
physicist_NOUN	физик_NOUN
admit_VERB	признавать_VERB
civilization_NOUN	цивилизация_NOUN
garcía_NOUN	гарсиа_NOUN
pin_NOUN	пин_NOUN
preston_NOUN	престон_NOUN
notion_NOUN	понятие_NOUN
doug_NOUN	даг_NOUN
manuscript_NOUN	рукопись_NOUN
crop_NOUN	урожай_NOUN
eugene_NOUN	юджин_NOUN
pipe_NOUN	трубка_NOUN
jake_NOUN	джейка_NOUN
sail_NOUN	парус_NOUN
cinematography_NOUN	кинематография_NOUN
substance_NOUN	вещество_NOUN
darkness_NOUN	темнота_NOUN
attraction_NOUN	влечение_NOUN
developer_NOUN	разработчик_NOUN
ball_NOUN	мяч_NOUN
cognitive_ADJ	когнитивный_ADJ
diploma_NOUN	аттестат_NOUN
philosopher_NOUN	философ_NOUN
carroll_NOUN	кэрроллар_NOUN
midland_NOUN	мидлендс_NOUN
authorize_VERB	разрешать_VERB
measurement_NOUN	измерение_NOUN
answer_VERB	отвечать_VERB
creature_NOUN	существо_NOUN
cleaning_NOUN	очистка_NOUN
variable_NOUN	переменная_NOUN
sacrifice_NOUN	жертва_NOUN
kiev_NOUN	кий_NOUN
assumption_NOUN	предположение_NOUN
carol_NOUN	кэрол_NOUN
saxophone_NOUN	саксофон_NOUN
sequence_NOUN	последовательность_NOUN
flooding_NOUN	наводнение_NOUN
violate_VERB	нарушать_VERB
legally_ADV	законно_ADV
glory_NOUN	слава_NOUN
refugee_NOUN	беженец_NOUN
wrestler_NOUN	борец_NOUN
hit_VERB	бить_VERB
algeria_NOUN	алжира_NOUN
imply_VERB	подразумевать_VERB
healthcare_NOUN	здравоохранение_NOUN
hole_NOUN	отверстие_NOUN
segment_NOUN	сегмент_NOUN
sin_NOUN	грех_NOUN
circle_NOUN	окружность_NOUN
portrait_NOUN	портрет_NOUN
roller_NOUN	роллер_NOUN
luther_NOUN	лютер_NOUN
survival_NOUN	выживание_NOUN
earn_VERB	зарабатывать_VERB
witch_NOUN	ведьма_NOUN
penalty_NOUN	наказание_NOUN
chelsea_NOUN	челсь_NOUN
weird_ADJ	странный_ADJ
chicken_NOUN	курица_NOUN
refuge_NOUN	убежище_NOUN
deeply_ADV	глубоко_ADV
prototype_NOUN	прототип_NOUN
ball_NOUN	шарик_NOUN
tributary_NOUN	приток_NOUN
striker_NOUN	личинка_NOUN
vampire_NOUN	вампир_NOUN
trinidad_NOUN	тринидад_NOUN
rotation_NOUN	ротация_NOUN
kit_NOUN	комплект_NOUN
nat_NOUN	нет_NOUN
mistake_NOUN	ошибка_NOUN
monarch_NOUN	монарх_NOUN
marina_NOUN	марина_NOUN
emma_NOUN	эмм_NOUN
teeth_NOUN	зуб_NOUN
trustee_NOUN	попечитель_NOUN
leipzig_NOUN	лейпцигй_NOUN
scatter_VERB	разбрасывать_VERB
hood_NOUN	капот_NOUN
bailey_NOUN	бейль_NOUN
inch_NOUN	дюйм_NOUN
shelter_NOUN	убежище_NOUN
estimate_NOUN	смета_NOUN
everybody_PRON	все_PRON
conference_NOUN	конференция_NOUN
inspector_NOUN	инспектор_NOUN
layer_NOUN	слой_NOUN
manufacture_NOUN	производство_NOUN
bavaria_NOUN	бавария_NOUN
mixture_NOUN	смесь_NOUN
attract_NOUN	привлечение_NOUN
burn_VERB	сжигать_VERB
missile_NOUN	ракета_NOUN
castle_NOUN	замок_NOUN
airborne_NOUN	воздух_NOUN
love_VERB	обожать_VERB
sculpture_NOUN	скульптура_NOUN
prairie_NOUN	прерия_NOUN
larva_NOUN	личинка_NOUN
openly_ADV	открыто_ADV
brass_NOUN	брасс_NOUN
winston_NOUN	уинстон_NOUN
discography_NOUN	дискография_NOUN
steal_VERB	красть_VERB
fever_NOUN	жар_NOUN
convoy_NOUN	конвой_NOUN
pastor_NOUN	пастор_NOUN
apartment_NOUN	апартамент_NOUN
refuse_VERB	отказываться_VERB
suffolk_NOUN	саффолк_NOUN
scout_NOUN	скаут_NOUN
surname_NOUN	фамилия_NOUN
blade_NOUN	клинок_NOUN
administer_VERB	управлять_VERB
consider_VERB	считать_VERB
breast_NOUN	грудь_NOUN
innovative_ADJ	новаторский_ADJ
thame_NOUN	темз_NOUN
prepare_VERB	подготавливать_VERB
mess_NOUN	беспорядок_NOUN
hang_VERB	висеть_VERB
kumar_NOUN	кумар_NOUN
ruler_NOUN	правитель_NOUN
accounting_NOUN	учет_NOUN
cowboy_NOUN	ковбой_NOUN
escort_NOUN	сопровождение_NOUN
lawsuit_NOUN	иск_NOUN
nominat_NOUN	выдвижение_NOUN
hostile_NOUN	противник_NOUN
fitness_NOUN	фитнес_NOUN
portion_NOUN	порция_NOUN
tasmania_NOUN	тасмание_NOUN
ethic_NOUN	этика_NOUN
patriot_NOUN	патриот_NOUN
treasurer_NOUN	казначей_NOUN
valve_NOUN	клапан_NOUN
delay_VERB	задерживаться_VERB
disaster_NOUN	бедствие_NOUN
polar_ADJ	полярный_ADJ
automobile_NOUN	автомобиль_NOUN
quarter_NOUN	четверть_NOUN
generation_NOUN	поколение_NOUN
escort_NOUN	эскорт_NOUN
geology_NOUN	геология_NOUN
velocity_NOUN	скорость_NOUN
loading_NOUN	загрузка_NOUN
blog_NOUN	блог_NOUN
quit_VERB	бросать_VERB
trick_NOUN	фокус_NOUN
andré_NOUN	андро_NOUN
cherry_NOUN	черри_NOUN
anton_NOUN	антон_NOUN
deliberately_ADV	намеренно_ADV
moment_NOUN	момент_NOUN
fight_NOUN	бой_NOUN
nixon_NOUN	никсон_NOUN
privacy_NOUN	конфиденциальность_NOUN
foundation_NOUN	фонд_NOUN
mysterious_ADJ	таинственный_ADJ
dimension_NOUN	аспект_NOUN
unified_ADJ	единый_ADJ
diploma_NOUN	диплом_NOUN
push_VERB	толкнуть_VERB
angry_ADJ	злой_ADJ
trace_NOUN	след_NOUN
stage_VERB	устраивать_VERB
politically_ADV	политически_ADV
explore_VERB	изучать_VERB
fire_NOUN	увольнение_NOUN
leicester_NOUN	лестирать_NOUN
repeat_VERB	повторять_VERB
circle_NOUN	круг_NOUN
varietie_NOUN	разновидность_NOUN
sustainable_ADJ	устойчивый_ADJ
bag_NOUN	пакет_NOUN
edwin_NOUN	эдвина_NOUN
deposit_NOUN	вклад_NOUN
derek_NOUN	дерек_NOUN
ethiopia_NOUN	эфиопия_NOUN
tourist_NOUN	турист_NOUN
sudden_ADV	внезапно_ADV
drive_VERB	ехать_VERB
mutual_ADJ	взаимный_ADJ
colleague_NOUN	коллега_NOUN
catalina_NOUN	каталин_NOUN
intensity_NOUN	интенсивность_NOUN
goddess_NOUN	богиня_NOUN
barne_NOUN	барнс_NOUN
shoulder_NOUN	плечо_NOUN
consequence_NOUN	последствие_NOUN
desire_VERB	желать_VERB
mode_NOUN	режим_NOUN
learn_VERB	учиться_VERB
dress_VERB	одевать_VERB
warning_NOUN	предупреждение_NOUN
silence_NOUN	тишина_NOUN
lou_NOUN	л_NOUN
gather_VERB	собираться_VERB
holding_NOUN	запас_NOUN
jorge_NOUN	хорхй_NOUN
translator_NOUN	переводчик_NOUN
diet_NOUN	диета_NOUN
joy_NOUN	радость_NOUN
separately_ADV	отдельно_ADV
direction_NOUN	направление_NOUN
setting_NOUN	параметр_NOUN
zoo_NOUN	зоопарк_NOUN
parish_NOUN	приход_NOUN
dale_NOUN	дейл_NOUN
adoption_NOUN	принятие_NOUN
remarkable_ADJ	замечательный_ADJ
steal_VERB	украсть_VERB
format_NOUN	формат_NOUN
listen_VERB	послушать_VERB
tongue_NOUN	язык_NOUN
richard_NOUN	ричардс_NOUN
recruit_VERB	набирать_VERB
erik_NOUN	эрика_NOUN
mediation_NOUN	посредничество_NOUN
clergy_NOUN	духовенство_NOUN
synthesis_NOUN	обобщение_NOUN
disappear_VERB	исчезать_VERB
bicycle_NOUN	велосипед_NOUN
tuesday_NOUN	вторник_NOUN
afternoon_NOUN	день_NOUN
lunar_ADJ	лунный_ADJ
ping_NOUN	пин_NOUN
bag_NOUN	мешок_NOUN
lesson_NOUN	урок_NOUN
load_VERB	загружать_VERB
shoe_NOUN	ботинок_NOUN
patron_NOUN	покровитель_NOUN
reliability_NOUN	надежность_NOUN
thomson_NOUN	томсона_NOUN
innovative_ADJ	инновационный_ADJ
saxony_NOUN	саксония_NOUN
mask_NOUN	маска_NOUN
eighteen_NUM	восемнадцать_NUM
tough_ADJ	крутой_ADJ
synthesis_NOUN	синтез_NOUN
educator_NOUN	педагог_NOUN
soprano_ADV	сопрано_ADV
telecommunication_NOUN	телекоммуникация_NOUN
fiji_NOUN	фидж_NOUN
sec_NOUN	секунда_NOUN
assignment_NOUN	задание_NOUN
garcía_NOUN	гарсия_NOUN
tan_NOUN	тан_NOUN
interprete_VERB	толковать_VERB
silence_NOUN	молчание_NOUN
expell_VERB	высылать_VERB
workshop_NOUN	семинар_NOUN
andrew_NOUN	эндрюс_NOUN
caroline_NOUN	каролин_NOUN
faction_NOUN	фракция_NOUN
harder_ADJ	трудный_ADJ
hey_NOUN	наследник_NOUN
commitment_NOUN	приверженность_NOUN
convoy_NOUN	колонна_NOUN
magnitude_NOUN	масштаб_NOUN
kilometre_NOUN	километр_NOUN
cheshire_NOUN	чешир_NOUN
archaeology_NOUN	археология_NOUN
blade_NOUN	лезвие_NOUN
lens_NOUN	линза_NOUN
exception_NOUN	исключение_NOUN
horizontal_ADJ	горизонтальный_ADJ
floor_NOUN	пол_NOUN
curve_NOUN	кривая_NOUN
command_NOUN	команда_NOUN
wish_NOUN	желание_NOUN
verify_VERB	проверять_VERB
permanently_ADV	постоянно_ADV
impose_VERB	вводить_VERB
silva_NOUN	сильва_NOUN
terminology_NOUN	терминология_NOUN
uprising_NOUN	восстание_NOUN
burma_NOUN	бирма_NOUN
suite_NOUN	люкс_NOUN
duck_NOUN	утка_NOUN
judaism_NOUN	иудаизм_NOUN
henderson_NOUN	хендерсона_NOUN
cox_NOUN	кокс_NOUN
imply_VERB	предполагать_VERB
cent_NOUN	цент_NOUN
johnston_NOUN	джонстон_NOUN
technically_ADV	технически_ADV
keyboard_NOUN	клавиатура_NOUN
copa_NOUN	кубок_NOUN
dirty_ADJ	грязный_ADJ
bike_NOUN	байк_NOUN
andrea_NOUN	андре_NOUN
integrity_NOUN	целостность_NOUN
casey_NOUN	кейси_NOUN
assignment_NOUN	уступка_NOUN
clarify_VERB	уточнять_VERB
lisbon_NOUN	лиссабон_NOUN
judgement_NOUN	суждение_NOUN
birth_NOUN	рождение_NOUN
exploration_NOUN	разведка_NOUN
jin_NOUN	джин_NOUN
icon_NOUN	значок_NOUN
like_VERB	любить_VERB
thermal_ADJ	тепловой_ADJ
warrior_NOUN	воин_NOUN
mammal_NOUN	млекопитающее_NOUN
sad_ADJ	грустный_ADJ
crops_NOUN	посев_NOUN
bat_NOUN	бит_NOUN
jam_NOUN	джем_NOUN
cluster_NOUN	скопление_NOUN
jeffrey_NOUN	джеффри_NOUN
mohammad_NOUN	мухаммед_NOUN
healthy_ADJ	здоровый_ADJ
kenny_NOUN	кеннь_NOUN
sherman_NOUN	шерман_NOUN
resignation_NOUN	отставка_NOUN
chamber_NOUN	палата_NOUN
scale_NOUN	весы_NOUN
announcement_NOUN	объявление_NOUN
victory_NOUN	победа_NOUN
contract_NOUN	контракт_NOUN
kilometer_NOUN	километр_NOUN
crops_NOUN	культура_NOUN
burton_NOUN	бёртон_NOUN
elevate_VERB	повышенный_VERB
monk_NOUN	монах_NOUN
tactical_ADJ	тактический_ADJ
melody_NOUN	мелодия_NOUN
honest_ADJ	честный_ADJ
dinner_NOUN	обед_NOUN
sue_NOUN	сь_NOUN
predominantly_ADV	преимущественно_ADV
pole_NOUN	поляк_NOUN
coin_NOUN	монета_NOUN
disable_VERB	отключать_VERB
boarding_NOUN	посадка_NOUN
genesis_NOUN	бытие_NOUN
sara_NOUN	сар_NOUN
world_NOUN	мир_NOUN
burial_NOUN	захоронение_NOUN
julie_NOUN	жють_NOUN
casino_NOUN	казино_NOUN
surgeon_NOUN	хирург_NOUN
confirm_NOUN	подтверждение_NOUN
buddhism_NOUN	буддизм_NOUN
assumption_NOUN	допущение_NOUN
badge_NOUN	значок_NOUN
wireless_ADJ	беспроводный_ADJ
objection_NOUN	возражение_NOUN
nicola_NOUN	николя_NOUN
bread_NOUN	хлеб_NOUN
lover_NOUN	любовник_NOUN
confederation_NOUN	конфедерация_NOUN
operator_NOUN	оператор_NOUN
santo_NOUN	сант_NOUN
patrolling_NOUN	патрулирование_NOUN
determi_VERB	определять_VERB
burton_NOUN	бартон_NOUN
voltage_NOUN	напряжение_NOUN
rifle_NOUN	ружье_NOUN
encounter_VERB	возникать_VERB
ring_NOUN	кольцо_NOUN
telecommunication_NOUN	связь_NOUN
prompt_VERB	побудить_VERB
fever_NOUN	лихорадка_NOUN
tube_NOUN	труба_NOUN
trumpet_NOUN	труба_NOUN
convince_VERB	убеждать_VERB
divorce_NOUN	развод_NOUN
flute_NOUN	флейта_NOUN
windsor_NOUN	виндзор_NOUN
estimate_VERB	оценивать_VERB
joel_NOUN	джоэл_NOUN
spel_VERB	писаться_VERB
naturally_ADV	естественно_ADV
sick_ADJ	больной_ADJ
frances_NOUN	фрэнсис_NOUN
complaint_NOUN	жалоба_NOUN
pleasure_NOUN	наслаждение_NOUN
equality_NOUN	равноправие_NOUN
accident_NOUN	происшествие_NOUN
mohammad_NOUN	мохаммад_NOUN
shoe_NOUN	обувь_NOUN
nowhere_ADV	никуда_ADV
cyclone_NOUN	циклон_NOUN
hood_NOUN	гуд_NOUN
saxon_NOUN	саксон_NOUN
knee_NOUN	колено_NOUN
cheese_NOUN	сыр_NOUN
hydrogen_NOUN	водород_NOUN
dancer_NOUN	танцор_NOUN
prize_NOUN	приз_NOUN
geometry_NOUN	геометрия_NOUN
colombian_ADJ	колумбийский_ADJ
define_VERB	определять_VERB
algeria_NOUN	алжир_NOUN
rod_NOUN	стержень_NOUN
luxembourg_NOUN	люксембург_NOUN
harper_NOUN	харпер_NOUN
prepare_VERB	подготавливаться_VERB
configuration_NOUN	конфигурация_NOUN
deliver_VERB	доставлять_VERB
happen_VERB	происходить_VERB
comparable_ADJ	сопоставимый_ADJ
carefully_ADV	внимательно_ADV
ace_NOUN	аттосекунда_NOUN
excess_NOUN	излишек_NOUN
accomplish_VERB	выполнять_VERB
pregnant_ADJ	беременный_ADJ
fur_NOUN	мех_NOUN
quarterfinal_NOUN	четвертьфинал_NOUN
garage_NOUN	гараж_NOUN
grain_NOUN	зерно_NOUN
rainbow_NOUN	радуга_NOUN
bomb_NOUN	бомба_NOUN
precise_ADJ	точный_ADJ
armour_NOUN	доспехи_NOUN
farm_NOUN	ферма_NOUN
trailer_NOUN	прицеп_NOUN
runway_NOUN	полоса_NOUN
rape_NOUN	изнасилование_NOUN
counsel_NOUN	советник_NOUN
brad_NOUN	бред_NOUN
accordingly_ADV	соответственно_ADV
treasury_NOUN	казначейство_NOUN
sixteen_NUM	шестнадцать_NUM
rican_NOUN	рика_NOUN
robertson_NOUN	робертсон_NOUN
brad_NOUN	брэд_NOUN
monte_NOUN	монт_NOUN
publicity_NOUN	публичность_NOUN
worcester_NOUN	вустирать_NOUN
coordinate_NOUN	координата_NOUN
informal_ADJ	неофициальный_ADJ
promise_NOUN	обещание_NOUN
sacramento_NOUN	сакраменвать_NOUN
vale_NOUN	вейл_NOUN
cooperative_NOUN	кооператив_NOUN
proportion_NOUN	доля_NOUN
excessive_ADJ	чрезмерный_ADJ
afternoon_NOUN	полдень_NOUN
string_NOUN	строка_NOUN
gibson_NOUN	гибсона_NOUN
pub_NOUN	паб_NOUN
kurt_NOUN	курт_NOUN
excess_NOUN	избыток_NOUN
entity_NOUN	субъект_NOUN
morrison_NOUN	моррисон_NOUN
routine_NOUN	рутина_NOUN
rod_NOUN	род_NOUN
advisor_NOUN	советник_NOUN
cia_NOUN	цр_NOUN
acceptance_NOUN	принятие_NOUN
fake_NOUN	фальшивка_NOUN
sketch_NOUN	скетч_NOUN
canva_NOUN	холст_NOUN
trap_NOUN	ловушка_NOUN
hope_VERB	надеяться_VERB
julia_NOUN	юлий_NOUN
resume_VERB	возобновлять_VERB
blow_NOUN	удар_NOUN
placement_NOUN	размещение_NOUN
cannon_NOUN	пушка_NOUN
bow_NOUN	поклон_NOUN
newman_NOUN	ньюмывать_NOUN
planet_NOUN	планета_NOUN
trip_NOUN	поездка_NOUN
prevention_NOUN	предотвращение_NOUN
nowhere_ADV	нигде_ADV
motto_NOUN	девиз_NOUN
systematic_ADJ	систематический_ADJ
reasonably_ADV	разумно_ADV
harmony_NOUN	гармония_NOUN
connect_VERB	соединять_VERB
macedonia_NOUN	македония_NOUN
crawford_NOUN	кроуфорда_NOUN
consult_NOUN	консультирование_NOUN
consumer_NOUN	потребитель_NOUN
ferguson_NOUN	фергюсон_NOUN
motorcycle_NOUN	мотоцикл_NOUN
appreciate_VERB	оценивать_VERB
port_NOUN	порт_NOUN
diet_NOUN	рацион_NOUN
curtis_NOUN	кертис_NOUN
drive_NOUN	диск_NOUN
drake_NOUN	дрейк_NOUN
compatible_ADJ	совместимый_ADJ
montenegro_NOUN	черногория_NOUN
harder_ADJ	сложно_ADJ
fossil_NOUN	ископаемое_NOUN
herman_NOUN	герман_NOUN
pleasure_NOUN	удовольствие_NOUN
wish_NOUN	пожелание_NOUN
smoke_NOUN	дым_NOUN
cite_NOUN	ситосить_NOUN
rat_NOUN	крыса_NOUN
brandon_NOUN	брендон_NOUN
roman_NOUN	римлянин_NOUN
gibraltar_NOUN	гибралтарин_NOUN
guatemala_NOUN	гватемал_NOUN
intense_ADJ	интенсивный_ADJ
withdraw_VERB	отзывать_VERB
lynn_NOUN	линн_NOUN
penalty_NOUN	санкция_NOUN
carefully_ADV	тщательно_ADV
withdraw_VERB	снимать_VERB
tactics_NOUN	тактика_NOUN
submarine_NOUN	субмарина_NOUN
geological_ADJ	геологический_ADJ
inscription_NOUN	надпись_NOUN
screenplay_NOUN	сценарист_NOUN
magnitude_NOUN	величина_NOUN
skull_NOUN	череп_NOUN
diversity_NOUN	многообразие_NOUN
petition_NOUN	петиция_NOUN
playwright_NOUN	драматург_NOUN
graduate_NOUN	выпускник_NOUN
ludwig_NOUN	людвиг_NOUN
cabin_NOUN	домик_NOUN
treasure_NOUN	сокровище_NOUN
specimen_NOUN	образец_NOUN
jail_NOUN	тюрьма_NOUN
phrase_NOUN	фраза_NOUN
shirt_NOUN	рубашка_NOUN
ping_NOUN	пинг_NOUN
configuration_NOUN	настройка_NOUN
broader_ADJ	широко_ADJ
withdrawal_NOUN	вывод_NOUN
ace_NOUN	туз_NOUN
theatrical_ADJ	театральный_ADJ
privately_ADV	конфиденциально_ADV
prussia_NOUN	пруссия_NOUN
expell_VERB	исключать_VERB
airfield_NOUN	аэродром_NOUN
genre_NOUN	жанр_NOUN
carlo_NOUN	карло_NOUN
santo_NOUN	санвать_NOUN
jung_NOUN	чон_NOUN
revolt_NOUN	восстание_NOUN
miscellaneous_ADJ	прочий_ADJ
lebanese_ADJ	ливанский_ADJ
recall_VERB	напоминать_VERB
jungle_NOUN	джунгли_NOUN
plane_NOUN	самолет_NOUN
legally_ADV	юридически_ADV
joshua_NOUN	джошуа_NOUN
kitchen_NOUN	кухня_NOUN
abortion_NOUN	аборт_NOUN
miscellaneous_ADJ	разный_ADJ
hey_INTJ	эй_INTJ
casting_NOUN	кастинг_NOUN
princes_NOUN	принц_NOUN
verify_VERB	подтверждать_VERB
crash_VERB	разбиваться_VERB
priority_NOUN	приоритет_NOUN
estimate_NOUN	оценка_NOUN
grant_NOUN	грант_NOUN
slovak_NOUN	словацкая_NOUN
crown_VERB	коронован_VERB
pocket_NOUN	карман_NOUN
nearest_ADJ	ближайший_ADJ
ball_NOUN	шар_NOUN
spy_NOUN	шпион_NOUN
murder_NOUN	убийство_NOUN
researcher_NOUN	исследователь_NOUN
oriental_ADJ	восточный_ADJ
trailer_NOUN	трейлер_NOUN
passion_NOUN	страсть_NOUN
